aba	a . b_< a
ababemi	a . b_< a . b_< E . m i
ababenokuyifumana	a . b_< a . b_< E . n O . k_> u . j i . f u . m a . n a
ababeyifumana	a . b_< a . b_< E . j i . f u . m a . n a
ababezidlulela	a . b_< a . b_< E . z i . K\ u . l E . l a
abagqibezeli	a . b_< a . !\g_0 i . b_< E . z E . l i
abahlali	a . b_< a . K a . l i
abahlobo	a . b_< a . K O . b_< O
abakhenkethi	a . b_< a . k_h E . n . k_> E . t_h i
abakhoyo	a . b_< a . k_h O . j O
abambe	a . b_< a . m b_< E
abanangqondo	a . b_< a . n a . N !\g_0 O . n d O
abanje	a . b_< a . n dZ E
abanokumnika	a . b_< a . n O . k_> u . m n i . k_> a
abantakwabo	a . b_< a . n t_> a . k_> w a . b_< O
abantu	a . b_< a . n t_> u
abantwana	a . b_< a . n t_> w a . n a
abanye	a . b_< a . J E
abaqeshi	a . b_< a . !\ E . S i
abasebenzi	a . b_< a . s E . b_< E . n z i
abaselula	a . b_< a . s E . l u . l a
abasetyhini	a . b_< a . s E . c_h i . n i
abathathu	a . b_< a . t_h a . t_h u
abatshele	a . b_< a . tS_h E . l E
abaxelele	a . b_< a . |\|\ E . l E . l E
abaxhasi	a . b_< a . |\|\_h a . s i
abazali	a . b_< a . z a . l i
abe	a . b_< E
abekrwada	a . b_< E . kx_> w a . d a
abel	a . b_< E l
abenza	a . b_< E . n z a
abetheke	a . b_< E . t_h E . k_> E
abhabha	a . b_h a . b_h a
abhabhe	a . b_h a . b_h E
abhabhele	a . b_h a . b_h E . l E
abhale	a . b_h a . l E
abize	a . b_< i . z E
abo	a . b_< O
abomvu	a . b_< O . m . v u
abukhali	a . b_< u . k_h a . l i
abukho	a . b_< u . k_h O
acoceke	a . |\ O . |\ E . k_> E
adlula	a . K\ u . l a
afika	a . f i . k_> a
afrika	a . f r i . k_> a
agasti	a . g a . s t_> i
agcine	a . |\g_0 i . n E
aha	a . h a
ahambe	a . h a . m b_< E
ahlale	a . K a . l E
ahlangana	a . K a . N g a . n a
ahlukileyo	a . K u . k_> i . l E . j O
ahlwahlwazayo	a . K w a . K w a . z a . j O
akakho	a . k_> a . k_h O
akanakudlala	a . k_> a . n a . k_> u . K\ a . l a
akasoze	a . k_> a . s O . z E
akazange	a . k_> a . z a . N g E
akeva	a . k_> E . v a
akha	a . k_h a
akhangeleka	a . k_h a . N g E . l E . k_> a
akhe	a . k_h E
akho	a . k_h O
akholelwe	a . k_h O . l E . l w E
akhuphisana	a . k_h u . p_h i . s a . n a
akinyi	a . k_> i . J i
akonwaba	a . k_> O . n w a . b_< a
akude	a . k_> u . d E
akufika	a . k_> u . f i . k_> a
akufuneki	a . k_> u . f u . n E . k_> i
akukho	a . k_> u . k_h O
akunjalo	a . k_> u . n dZ a . l O
akusemnandi	a . k_> u . s E . m n a . n d i
akuthi	a . k_> u . t_h i
akwazi	a . k_> w a . z i
ala	a . l a
alale	a . l a . l E
ali	a . l i
alinganayo	a . l i . N g a . n a . j O
alintshontshile	a . l i . n tS_> O . n tS_> i . l E
alishumi	a . l i . S u . m i
alo	a . l O
aluphumelele	a . l u . p_h u . m E . l E . l E
am	a . m
ama	a . m a
amabali	a . m a . b_< a . l i
amabamba	a . m a . b_< a . m b_< a
amabhabhathane	a . m a . b_h a . b_h a . t_h a . n E
amabini	a . m a . b_< i . n i
amacala	a . m a . |\ a . l a
amadlakadlaka	a . m a . K\ a . k_> a . K\ a . k_> a
amadlala	a . m a . K\ a . l a
amadlavu	a . m a . K\ a . v u
amadoda	a . m a . d O . d a
amafu	a . m a . f u
amagama	a . m a . g a . m a
amagqabi	a . m a . !\g_0 a . b_< i
amahlanu	a . m a . K a . n u
amahle	a . m a . K E
amajoni	a . m a . dZ O . n i
amakhaphetshu	a . m a . k_h a . p_h E . tS_h u
amakhaya	a . m a . k_h a . j a
amancinane	a . m a . n |\ i . n a . n E
amane	a . m a . n E
amaninzi	a . m a . n i . n z i
amanqaku	a . m a . n !\ a . k_> u
amantombazana	a . m a . n t_> O . m b_< a . z a . n a
amantshontsho	a . m a . n tS_> O . n tS_> O
amantshontshwana	a . m a . n tS_> O . n tS_> w a . n a
amantshontso	a . m a . n tS_> O . n ts_> O
amanzi	a . m a . n z i
amaorenji	a . m a . O . r E . n dZ i
amaphiko	a . m a . p_h i . k_> O
amapolisa	a . m a . p_> O . l i . s a
amaqabane	a . m a . !\ a . b_< a . n E
amaqanda	a . m a . !\ a . n d a
amaqela	a . m a . !\ E . l a
amaqhekezana	a . m a . !\_h E . k_> E . z a . n a
amaqhosha	a . m a . !\_h O . S a
amaqondo	a . m a . !\ O . n d O
amareyi	a . m a . r E . j i
amasebe	a . m a . s E . b_< E
amasele	a . m a . s E . l E
amashumi	a . m a . S u . m i
amathathu	a . m a . t_h a . t_h u
amathuba	a . m a . t_h u . b_< a
amathumbu	a . m a . t_h u . m b_< u
amatye	a . m a . c_> E
amawa	a . m a . w a
amawaka	a . m a . w a . k_> a
amaxesha	a . m a . |\|\ E . S a
amayizele	a . m a . j i . z E . l E
amazinyo	a . m a . z i . J O
amazulu	a . m a . z u . l u
amazwe	a . m a . z w E
amazwi	a . m a . z w i
ambalwa	a . m b_< a . l w a
ambombozele	a . m b_< O . m b_< O . z E . l E
amehlo	a . m E . K O
amendu	a . m E . n d u
amenyezele	a . m E . J E . z E . l E
amhle	a . m K E
amhlophe	a . m K O . p_h E
amnandi	a . m n a . n d i
amnyama	a . m J a . m a
amoyizele	a . m O . j i . z E . l E
amqengqelezi	a . m . !\ E . N !\g_0 E . l E . z i
andasitya	a . n d a . s i . c_> a
andenzi	a . n d E . n z i
andichithise	a . n d i . |\_h i . t_h i . s E
andikuncedanga	a . n d i . k_> u . n |\ E . d a . N g a
andikwazi	a . n d i . k_> w a . z i
andilifumani	a . n d i . l i . f u . m a . n i
andinamandla	a . n d i . n a . m a . n K\ a
andiqondi	a . n d i . !\ O . n d i
andisayi	a . n d i . s a . j i
andizokubaleka	a . n d i . z O . k_> u . b_< a . l E . k_> a
anemihlathi	a . n E . m i . K a . t_h i
anenkungu	a . n E . n . k_> u . N g u
angabina	a . N g a . b_< i . n a
angakudubula	a . N g a . k_> u . d u . b_< u . l a
angamakhulu	a . N g a . m a . k_h u . l u
angangentloko	a . N g a . N g E . n tK_> O . k_> O
angaphantsi	a . N g a . p_h a . n ts_> i
angaqhubekeki	a . N g a . !\_h u . b_< E . k_> E . k_> i
angathi	a . N g a . t_h i
angavamile	a . N g a . v a . m i . l E
angcono	a . N |\g_0 O . n O
angenisiwe	a . N g E . n i . s i . w E
angola	a . N g O . l a
angu	a . N g u
anibusise	a . n i . b_< u . s i . s E
anomsindo	a . n O . m s i . n d O
anxibe	a . n |\|\ i . b_< E
apha	a . p_h a
aphefumula	a . p_h E . f u . m u . l a
aphezulu	a . p_h E . z u . l u
apho	a . p_h O
aphuma	a . p_h u . m a
apile	a . p_> i . l E
aram	a . r a . m
asavela	a . s a . v E . l a
ase	a . s E
asekwe	a . s E . k_> w E
aseluhlaza	a . s E . l u . K a . z a
asempuma	a . s E . m p_> u . m a
ashinyeneyo	a . S i . J E . n E . j O
ashiya	a . S i . j a
asi	a . s i
asibamba	a . s i . b_< a . m b_< a
asiboni	a . s i . b_< O . n i
asibuza	a . s i . b_< u . z a
asisesihle	a . s i . s E . s i . K E
athe	a . t_h E
athengisa	a . t_h E . N g i . s a
athethe	a . t_h E . t_h E
athi	a . t_h i
atsho	a . tS_h O
atsibe	a . ts_> i . b_< E
atsibele	a . ts_> i . b_< E . l E
atyhafe	a . c_h a . f E
avareji	a . v a . r E . dZ i
avuleka	a . v u . l E . k_> a
avuthiweyo	a . v u . t_h i . w E . j O
awakavuthwa	a . w a . k_> a . v u . t_h w a
awakuqhatha	a . w a . k_> u . !\_h a . t_h a
awakuthanda	a . w a . k_> u . t_h a . n d a
awakwazi	a . w a . k_> w a . z i
awamshiya	a . w a . m S i . j a
awele	a . w E . l E
awo	a . w O
awodlula	a . w O . K\ u . l a
awukwazi	a . w u . k_> w a . z i
awunamazinyo	a . w u . n a . m a . z i . J O
awuphozisanga	a . w u . p_h O . z i . s a . N g a
ayakuba	a . j a . k_> u . b_< a
ayaphaphatheka	a . j a . p_h a . p_h a . t_h E . k_> a
aye	a . j E
ayebonakala	a . j E . b_< O . n a . k_> a . l a
ayegquma	a . j E . !\g_0 u . m a
ayemancinane	a . j E . m a . n |\ i . n a . n E
ayengamhoyanga	a . j E . N g a . m_h O . j a . N g a
ayequkuqela	a . j E . !\ u . k_> u . !\ E . l a
ayeyi	a . j E . j i
ayi	a . j i
ayifani	a . j i . f a . n i
ayifuni	a . j i . f u . n i
ayigcine	a . j i . |\g_0 i . n E
ayikho	a . j i . k_h O
ayiyeke	a . j i . j E . k_> E
ayizange	a . j i . z a . N g E
azakunceda	a . z a . k_> u . n |\ E . d a
azapo	a . z a . p_> O
aze	a . z E
azelwe	a . z E . l w E
azibuhlungu	a . z i . b_< u . K u . N g u
azibusayo	a . z i . b_< u . s a . j O
azigutyule	a . z i . g u . c_> u . l E
azimele	a . z i . m E . l E
azimnyamanga	a . z i . m J a . m a . N g a
azo	a . z O
azotya	a . z O . c_> a
azoyifumana	a . z O . j i . f u . m a . n a
baba	b_< a . b_< a
babafota	b_< a . b_< a . f O . t_> a
babebanjwa	b_< a . b_< E . b_< a . n dZ w a
babebasa	b_< a . b_< E . b_< a . s a
babebase	b_< a . b_< E . b_< a . s E
babedidekile	b_< a . b_< E . d i . d E . k_> i . l E
babehlala	b_< a . b_< E . K a . l a
babehlulwe	b_< a . b_< E . K u . l w E
babencokola	b_< a . b_< E . n |\ O . k_> O . l a
babexhomekeke	b_< a . b_< E . |\|\_h O . m E . k_> E . k_> E
babhabha	b_< a . b_h a . b_h a
babizwa	b_< a . b_< i . z w a
babo	b_< a . b_< O
babulala	b_< a . b_< u . l a . l a
babungaveli	b_< a . b_< u . N g a . v E . l i
babutshe	b_< a . b_< u . tS_h E
babuyela	b_< a . b_< u . j E . l a
babuzolile	b_< a . b_< u . z O . l i . l E
bachwechwa	b_< a . |\_h w E . |\_h w a
bade	b_< a . d E
badlale	b_< a . K\ a . l E
bafana	b_< a . f a . n a
bafikelele	b_< a . f i . k_> E . l E . l E
bafumana	b_< a . f u . m a . n a
bafumane	b_< a . f u . m a . n E
bafunde	b_< a . f u . n d E
baguquke	b_< a . g u . !\ u . k_> E
bahamba	b_< a . h a . m b_< a
bahleka	b_< a . K E . k_> a
bajonga	b_< a . dZ O . N g a
baka	b_< a . k_> a
bakhala	b_< a . k_h a . l a
bakhe	b_< a . k_h E
bakho	b_< a . k_h O
bakufika	b_< a . k_> u . f i . k_> a
bala	b_< a . l a
bali	b_< a . l i
bam	b_< a . m
bama	b_< a . m a
bamashishini	b_< a . m a . S i . S i . n i
bambelela	b_< a . m b_< E . l E . l a
bamcela	b_< a . m . |\ E . l a
bamlumkisa	b_< a . m . l u . m k_> i . s a
bamshiya	b_< a . m S i . j a
bamshiye	b_< a . m S i . j E
bancuma	b_< a . n |\ u . m a
banda	b_< a . n d a
banemisila	b_< a . n E . m i . s i . l a
bangakwaziyo	b_< a . N g a . k_> w a . z i . j O
bangena	b_< a . N g E . n a
bango	b_< a . N g O
bangolwesi	b_< a . N g O . l w E . s i
bangqundana	b_< a . N !\g_0 u . n d a . n a
bantustan	b_< a . n t_> u . s t_> a . n
bantwana	b_< a . n t_> w a . n a
baphela	b_< a . p_h E . l a
baphinda	b_< a . p_h i . n d a
baphumelele	b_< a . p_h u . m E . l E . l E
baqhagamshelane	b_< a . !\_h a . g a . m S E . l a . n E
baqhawula	b_< a . !\_h a . w u . l a
baqhubeka	b_< a . !\_h u . b_< E . k_> a
baqikileka	b_< a . !\ i . k_> i . l E . k_> a
baqubha	b_< a . !\ u . b_h a
barhoqoza	b_< a . x O . !\ O . z a
basa	b_< a . s a
base	b_< a . s E
basetyenziswa	b_< a . s E . c_> E . n z i . s w a
bathe	b_< a . t_h E
bathi	b_< a . t_h i
batshintsha	b_< a . tS_h i . n tS_> a
bavela	b_< a . v E . l a
bavumelana	b_< a . v u . m E . l a . n a
bavumele	b_< a . v u . m E . l E
baxhawulane	b_< a . |\|\_h a . w u . l a . n E
baya	b_< a . j a
bayahamba	b_< a . j a . h a . m b_< a
bayakusuka	b_< a . j a . k_> u . s u . k_> a
bayala	b_< a . j a . l a
bayasebenza	b_< a . j a . s E . b_< E . n z a
baye	b_< a . j E
bayifikelela	b_< a . j i . f i . k_> E . l E . l a
baza	b_< a . z a
bazakujonga	b_< a . z a . k_> u . dZ O . N g a
bazama	b_< a . z a . m a
baze	b_< a . z E
bazodlala	b_< a . z O . K\ a . l a
be	b_< E
bebefumana	b_< E . b_< E . f u . m a . n a
bebethwa	b_< E . b_< E . t_h w a
bebeyakujongeka	b_< E . b_< E . j a . k_> u . dZ O . N g E . k_> a
bebona	b_< E . b_< O . n a
bebuza	b_< E . b_< u . z a
becula	b_< E . |\ u . l a
bedlala	b_< E . K\ a . l a
beentyatyambo	b_< E . E . n . c_> a . c_> a . m b_< O
befika	b_< E . f i . k_> a
befolele	b_< E . f O . l E . l E
begula	b_< E . g u . l a
behamba	b_< E . h a . m b_< a
behleka	b_< E . K E . k_> a
bekebandakanyeka	b_< E . k_> E . b_< a . n d a . k_> a . J E . k_> a
bekufanele	b_< E . k_> u . f a . n E . l E
bekufuneka	b_< E . k_> u . f u . n E . k_> a
bekulilo	b_< E . k_> u . l i . l O
bekumele	b_< E . k_> u . m E . l E
bekumnandi	b_< E . k_> u . m n a . n d i
belikuphethe	b_< E . l i . k_> u . p_h E . t_h E
bemi	b_< E . m i
bendicinga	b_< E . n d i . |\ i . N g a
bendingoyena	b_< E . n d i . N g O . j E . n a
bendinotywala	b_< E . n d i . n O . c_> w a . l a
bendithunywe	b_< E . n d i . t_h u . J w E
bengatshongo	b_< E . N g a . tS_h O . N g O
bengoyiswanga	b_< E . N g O . j i . s w a . N g a
benkululeko	b_< E . n . k_> u . l u . l E . k_> O
benyuka	b_< E . J u . k_> a
bephindaphinda	b_< E . p_h i . n d a . p_h i . n d a
beqabane	b_< E . !\ a . b_< a . n E
bese	b_< E . s E
beseklasini	b_< E . s E . k_> l a . s i . n i
beshenxisiwe	b_< E . S E . n |\|\ i . s i . w E
besini	b_< E . s i . n i
besiqhulana	b_< E . s i . !\_h u . l a . n a
besiseko	b_< E . s i . s E . k_> O
besithethe	b_< E . s i . t_h E . t_h E
besitya	b_< E . s i . c_> a
besiya	b_< E . s i . j a
bethengisa	b_< E . t_h E . N g i . s a
bethule	b_< E . t_h u . l E
betsibe	b_< E . ts_> i . b_< E
betyeli	b_< E . c_> E . l i
beva	b_< E . v a
bevela	b_< E . v E . l a
beza	b_< E . z a
bhanisi	b_h a . n i . s i
bhanya	b_h a . J a
bhanyabhanya	b_h a . J a . b_h a . J a
bhedi	b_h E . d i
bheka	b_h E . k_> a
bhlowu	b_h l O . w u
bhola	b_h O . l a
bhoola	b_h O . O . l a
bhozo	b_h O . z O
bhulukhwe	b_h u . l u . k_h w E
bhuu	b_h u . u
bini	b_< i . n i
bo	b_< O
bobunewunewu	b_< O . b_< u . n E . w u . n E . w u
bokufunda	b_< O . k_> u . f u . n d a
bom	b_< O . m
bomiwa	b_< O . m i . w a
bomlibo	b_< O . m . l i . b_< O
bomvu	b_< O . m . v u
bongani	b_< O . N g a . n i
bonke	b_< O . n . k_> E
bontle	b_< O . n tK_> E
bophuthatswana	b_< O . p_h u . t_h a . ts_> w a . n a
botshelo	b_< O . tS_h E . l O
brashi	b_< r a . S i
brithani	b_< r i . t_h a . n i
bubuvuvu	b_< u . b_< u . v u . v u
buka	b_< u . k_> a
bumnqanda	b_< u . m . n !\ a . n d a
buncutshe	b_< u . n |\ u . tS_h E
bunekhephu	b_< u . n E . k_h E . p_h u
buqhuma	b_< u . !\_h u . m a
buqu	b_< u . !\ u
burhawuka	b_< u . x a . w u . k_> a
bushushu	b_< u . S u . S u
busuku	b_< u . s u . k_> u
butshe	b_< u . tS_h E
butyheli	b_< u . c_h E . l i
buyamlumkisa	b_< u . j a . m . l u . m k_> i . s a
buyandoyisa	b_< u . j a . n d O . j i . s a
buzi	b_< u . z i
cawa	|\ a . w a
cebo	|\ E . b_< O
chapha	|\_h a . p_h a
chintsa	|\_h i . n ts_> a
chintu	|\_h i . n t_> u
chu	|\_h u
cingo	|\ i . N g O
cum	|\ u . m
cwaka	|\ w a . k_> a
dala	d a . l a
dasara	d a . s a . r a
de	d E
dheema	d E . E . m a
dini	d i . n i
disemba	d i . s E . m b_< a
dolophu	d O . l O . p_h u
domino	d O . m i . n O
donki	d O . n . k_> i
dube	d u . b_< E
dyakalashe	J\ a . k_> a . l a . S E
dyalakashe	J\ a . l a . k_> a . S E
e	E
ebaleka	E . b_< a . l E . k_> a
ebaleni	E . b_< a . l E . n i
ebefundisa	E . b_< E . f u . n d i . s a
ebehleka	E . b_< E . K E . k_> a
ebengacacelanga	E . b_< E . N g a . |\ a . |\ E . l a . N g a
ebengaphethanga	E . b_< E . N g a . p_h E . t_h a . N g a
ebeshiyekile	E . b_< E . S i . j E . k_> i . l E
ebeyingxenye	E . b_< E . j i . N |\|\g_0 E . J E
ebhabha	E . b_h a . b_h a
ebheke	E . b_h E . k_> E
ebhodini	E . b_h O . d i . n i
ebhokisini	E . b_h O . k_> i . s i . n i
eblowu	E . b_< l O . w u
ebomvu	E . b_< O . m . v u
ebonakala	E . b_< O . n a . k_> a . l a
ebonakalisa	E . b_< O . n a . k_> a . l i . s a
ebonisa	E . b_< O . n i . s a
ebudaleni	E . b_< u . d a . l E . n i
ebugolide	E . b_< u . g O . l i . d E
ebumnyameni	E . b_< u . m J a . m E . n i
ebungcuka	E . b_< u . N |\g_0 u . k_> a
ebusika	E . b_< u . s i . k_> a
ebusuku	E . b_< u . s u . k_> u
ebuya	E . b_< u . j a
ebuyela	E . b_< u . j E . l a
ebuyele	E . b_< u . j E . l E
ecaleni	E . |\ a . l E . n i
ecaweni	E . |\ a . w E . n i
echophile	E . |\_h O . p_h i . l E
echulumancile	E . |\_h u . l u . m a . n |\ i . l E
ecinga	E . |\ i . N g a
ecingweni	E . |\ i . N g w E . n i
ecothoza	E . |\ O . t_h O . z a
ecula	E . |\ u . l a
ecuthekileyo	E . |\ u . t_h E . k_> i . l E . j O
edikwe	E . d i . k_> w E
edlalwa	E . K\ a . l w a
edlelweni	E . K\ E . l w E . n i
edlulileyo	E . K\ u . l i . l E . j O
ee	E . E
efama	E . f a . m a
efestileni	E . f E . s t_> i . l E . n i
efikelwe	E . f i . k_> E . l w E
efuna	E . f u . n a
egoduka	E . g O . d u . k_> a
egqabini	E . !\g_0 a . b_< i . n i
egqadaza	E . !\g_0 a . d a . z a
egramza	E . G a . m z a
egumbini	E . g u . m b_< i . n i
egutyiweyo	E . g u . c_> i . w E . j O
egxininisisa	E . |\|\g_0 i . n i . n i . s i . s a
ehamba	E . h a . m b_< a
ehlabathini	E . K a . b_< a . t_h i . n i
ehlafuna	E . K a . f u . n a
ehlathini	E . K a . t_h i . n i
ehle	E . K E
ehleka	E . K E . k_> a
ehlotyeni	E . K O . c_> E . n i
ehlwa	E . K w a
ehokweni	E . h O . k_> w E . n i
ehotele	E . h O . t_> E . l E
ejikelezayo	E . dZ i . k_> E . l E . z a . j O
ejinga	E . dZ i . N g a
ejiwuzisa	E . dZ i . w u . z i . s a
ejonge	E . dZ O . N g E
ekhabhathini	E . k_h a . b_h a . t_h i . n i
ekhala	E . k_h a . l a
ekhangela	E . k_h a . N g E . l a
ekhankanywa	E . k_h a . n . k_> a . J w a
ekhathazekileyo	E . k_h a . t_h a . z E . k_> i . l E . j O
ekhatyelwa	E . k_h a . c_> E . l w a
ekhaya	E . k_h a . j a
ekhayeni	E . k_h a . j E . n i
ekhefuzela	E . k_h E . f u . z E . l a
ekhethekileyo	E . k_h E . t_h E . k_> i . l E . j O
ekhishini	E . k_h i . S i . n i
ekhitshini	E . k_h i . tS_h i . n i
ekhohlo	E . k_h O . K O
ekhokelwa	E . k_h O . k_> E . l w a
ekhuphuka	E . k_h u . p_h u . k_> a
ekhwaza	E . k_h w a . z a
eklasini	E . k_> l a . s i . n i
ekoneni	E . k_> O . n E . n i
eku	E . k_> u
ekubeni	E . k_> u . b_< E . n i
ekufuphi	E . k_> u . f u . p_h i
ekufutshane	E . k_> u . f u . tS_h a . n E
ekugqibeleni	E . k_> u . !\g_0 i . b_< E . l E . n i
ekuhambeni	E . k_> u . h a . m b_< E . n i
ekuma	E . k_> u . m a
ekunene	E . k_> u . n E . n E
ekupheleni	E . k_> u . p_h E . l E . n i
ekuqaleni	E . k_> u . !\ a . l E . n i
ekuseni	E . k_> u . s E . n i
ekuvalweni	E . k_> u . v a . l w E . n i
ekwakhiweni	E . k_> w a . k_h i . w E . n i
ekwakumele	E . k_> w a . k_> u . m E . l E
ekwenza	E . k_> w E . n z a
ekwifama	E . k_> w i . f a . m a
ela	E . l a
elalikrobe	E . l a . l i . kx_> O . b_< E
elalikule	E . l a . l i . k_> u . l E
elandelayo	E . l a . n d E . l a . j O
elangeni	E . l a . N g E . n i
elasekhohlo	E . l a . s E . k_h O . K O
elasekunene	E . l a . s E . k_> u . n E . n E
elasekwa	E . l a . s E . k_> w a
elawulayo	E . l a . w u . l a . j O
elenza	E . l E . n z a
eleqwa	E . l E . !\ w a
eli	E . l i
elibala	E . l i . b_< a . l a
elibiweyo	E . l i . b_< i . w E . j O
elibomvu	E . l i . b_< O . m . v u
eliceba	E . l i . |\ E . b_< a
elide	E . l i . d E
elifanayo	E . l i . f a . n a . j O
elifutshane	E . l i . f u . tS_h a . n E
elihle	E . l i . K E
elijikelezwe	E . l i . dZ i . k_> E . l E . z w E
elikhulu	E . l i . k_h u . l u
elikrelekrele	E . l i . kx_> E . l E . kx_> E . l E
elila	E . l i . l a
eliluhlaza	E . l i . l u . K a . z a
elimhlophe	E . l i . m K O . p_h E
elimnandi	E . l i . m n a . n d i
elincinane	E . l i . n |\ i . n a . n E
elincinci	E . l i . n |\ i . n |\ i
elinesibhozo	E . l i . n E . s i . b_h O . z O
elinesithandathu	E . l i . n E . s i . t_h a . n d a . t_h u
elingakanani	E . l i . N g a . k_> a . n a . n i
elingaphesheya	E . l i . N g a . p_h E . S E . j a
elingcono	E . l i . N |\g_0 O . n O
elingoyiswanga	E . l i . N g O . j i . s w a . N g a
elingqokolayo	E . l i . N !\g_0 O . k_> O . l a . j O
elingqukuva	E . l i . N !\g_0 u . k_> u . v a
elingu	E . l i . N g u
elingudileyo	E . l i . N g u . d i . l E . j O
elingwevu	E . l i . N g w E . v u
elinika	E . l i . n i . k_> a
elinye	E . l i . J E
eliphakamileyo	E . l i . p_h a . k_> a . m i . l E . j O
eliphambi	E . l i . p_h a . m b_< i
elipheleleyo	E . l i . p_h E . l E . l E . j O
elisehlathini	E . l i . s E . K a . t_h i . n i
elisezantsi	E . l i . s E . z a . n ts_> i
elishumi	E . l i . S u . m i
elithi	E . l i . t_h i
elithuthuzelayo	E . l i . t_h u . t_h u . z E . l a . j O
elityheli	E . l i . c_h E . l i
elivele	E . l i . v E . l E
elivuthiweyo	E . l i . v u . t_h i . w E . j O
eliyilwe	E . l i . j i . l w E
elo	E . l O
elomileyo	E . l O . m i . l E . j O
elongezelelweyo	E . l O . N g E . z E . l E . l w E . j O
elongeziweyo	E . l O . N g E . z i . w E . j O
eludakeni	E . l u . d a . k_> E . n i
elugqatsweni	E . l u . !\g_0 a . ts_> w E . n i
eluhlaza	E . l u . K a . z a
elula	E . l u . l a
elungileyo	E . l u . N g i . l E . j O
elunxwemeni	E . l u . n |\|\ w E . m E . n i
elwandle	E . l w a . n K\ E
emafini	E . m a . f i . n i
emagxeni	E . m a . |\|\g_0 E . n i
emahle	E . m a . K E
emalikeni	E . m a . l i . k_> E . n i
eman'	E . m a . n
emandla	E . m a . n K\ a
emane	E . m a . n E
emanzini	E . m a . n z i . n i
emarikeni	E . m a . r i . k_> E . n i
ematsheni	E . m a . tS_h E . n i
embala	E . m b_< a . l a
embhedeni	E . m . b_h E . d E . n i
embi	E . m b_< i
embizeni	E . m b_< i . z E . n i
embonisa	E . m b_< O . n i . s a
embukele	E . m b_< u . k_> E . l E
embulu	E . m b_< u . l u
emcingeni	E . m . |\ i . N g E . n i
emehlweni	E . m E . K w E . n i
emele	E . m E . l E
emfumbathisa	E . m . f u . m b_< a . t_h i . s a
emgibeni	E . m . g i . b_< E . n i
emgxobhozweni	E . m . |\|\g_0 O . b_h O . z w E . n i
emhlabeni	E . m K a . b_< E . n i
emhlana	E . m K a . n a
emhlane	E . m K a . n E
emhlophe	E . m K O . p_h E
emibini	E . m i . b_< i . n i
emide	E . m i . d E
emifishane	E . m i . f i . S a . n E
emine	E . m i . n E
emini	E . m i . n i
emininzi	E . m i . n i . n z i
emiqolombeni	E . m i . !\ O . l O . m b_< E . n i
emiqolweni	E . m i . !\ O . l w E . n i
emithathu	E . m i . t_h a . t_h u
emitsha	E . m i . tS_h a
emke	E . m k_> E
emlanjeni	E . m . l a . n dZ E . n i
emlilweni	E . m . l i . l w E . n i
emlumkisa	E . m . l u . m k_> i . s a
emnandi	E . m n a . n d i
emngcwabeni	E . m . N |\g_0 w a . b_< E . n i
emngxunyeni	E . m . N |\|\g_0 u . J E . n i
emnyango	E . m J a . N g O
emotweni	E . m O . t_> w E . n i
emoyeni	E . m O . j E . n i
emqolo	E . m . !\ O . l O
emqolombeni	E . m . !\ O . l O . m b_< E . n i
emthini	E . m t_h i . n i
emthubi	E . m t_h u . b_< i
emthunzini	E . m t_h u . n z i . n i
emva	E . m . v a
emxhawula	E . m . |\|\_h a . w u . l a
emxinwa	E . m . |\|\ i . n w a
emyezweni	E . m j E . z w E . n i
enamabala	E . n a . m a . b_< a . l a
enamachokoza	E . n a . m a . |\_h O . k_> O . z a
enamagqabi	E . n a . m a . !\g_0 a . b_< i
enaninalo	E . n a . n i . n a . l O
encinane	E . n |\ i . n a . n E
encinci	E . n |\ i . n |\ i
endala	E . n d a . l a
endaweni	E . n d a . w E . n i
ende	E . n d E
endimhle	E . n d i . m K E
endinokuqubha	E . n d i . n O . k_> u . !\ u . b_h a
endiyithwalayo	E . n d i . j i . t_h w a . l a . j O
endiza	E . n d i . z a
endle	E . n K\ E
endlebeni	E . n K\ E . b_< E . n i
endleleni	E . n K\ E . l E . n i
endlini	E . n K\ i . n i
endlwini	E . n K\ w i . n i
endulwini	E . n d u . l w i . n i
enemibala	E . n E . m i . b_< a . l a
eneneni	E . n E . n E . n i
enesiqingatha	E . n E . s i . !\ i . N g a . t_h a
eneziqhamo	E . n E . z i . !\_h a . m O
engacacanga	E . N g a . |\ a . |\ a . N g a
engachithanga	E . N g a . |\_h i . t_h a . N g a
engaguqukanga	E . N g a . g u . !\ u . k_> a . N g a
engaka	E . N g a . k_> a
engalawulekiyo	E . N g a . l a . w u . l E . k_> i . j O
engamandla	E . N g a . m a . n K\ a
engaphethanga	E . N g a . p_h E . t_h a . N g a
engaqhelekanga	E . N g a . !\_h E . l E . k_> a . N g a
engasithengelanga	E . N g a . s i . t_h E . N g E . l a . N g a
engazi	E . N g a . z i
engceni	E . N |\g_0 E . n i
engekayigqibi	E . N g E . k_> a . j i . !\g_0 i . b_< i
engekhe	E . N g E . k_h E
engoyiswanga	E . N g O . j i . s w a . N g a
engu	E . N g u
engxamile	E . N |\|\g_0 a . m i . l E
engxhama	E . N |\|\g_0 a . m a
engxoweni	E . N |\|\g_0 O . w E . n i
enhliziyweni	E . n K i . z i . j i . w E . n i
enikelwa	E . n i . k_> E . l w a
enjaya	E . n dZ a . j a
enkosi	E . n . k_> O . s i
enkrwamza	E . n . kx_> w a . m z a
enkulu	E . n . k_> u . l u
enkwamla	E . n . k_> w a . m . l a
enobuhle	E . n O . b_< u . K E
enomonde	E . n O . m O . n d E
enophahla	E . n O . p_h a . K a
enqanaweni	E . n !\ a . n a . w E . n i
entanyeni	E . n t_> a . J E . n i
entla	E . n tK_> a
entle	E . n tK_> E
entliziyweni	E . n tK_> i . z i . j i . w E . n i
entloko	E . n tK_> O . k_> O
entlokweni	E . n tK_> O . k_> w E . n i
entsha	E . n tS_> a
entshona	E . n tS_> O . n a
enwenwayo	E . n w E . n w a . j O
enye	E . J E
enzima	E . n z i . m a
ephakathi	E . p_h a . k_> a . t_h i
ephambeneyo	E . p_h a . m b_< E . n E . j O
ephambili	E . p_h a . m b_< i . l i
ephelelwa	E . p_h E . l E . l w a
ephethe	E . p_h E . t_h E
ephethwe	E . p_h E . t_h w E
ephikweni	E . p_h i . k_> w E . n i
ephinda	E . p_h i . n d a
ephuma	E . p_h u . m a
ephumayo	E . p_h u . m a . j O
ephume	E . p_h u . m E
ephupheni	E . p_h u . p_h E . n i
epokothweni	E . p_> O . k_> O . t_h w E . n i
eqala	E . !\ a . l a
eqaqambileyo	E . !\ a . !\ a . m b_< i . l E . j O
eqaqanjelwa	E . !\ a . !\ a . n dZ E . l w a
eqhubeka	E . !\_h u . b_< E . k_> a
eqhusheka	E . !\_h u . S E . k_> a
eqhutywa	E . !\_h u . c_> w a
eqhwaba	E . !\_h w a . b_< a
eqinileyo	E . !\ i . n i . l E . j O
eqolozele	E . !\ O . l O . z E . l E
equlathe	E . !\ u . l a . t_h E
equleni	E . !\ u . l E . n i
erenkini	E . r E . n . k_> i . n i
erhuqayo	E . x u . !\ a . j O
esabanjwe	E . s a . b_< a . n dZ w E
esahlukileyo	E . s a . K u . k_> i . l E . j O
esasonka	E . s a . s O . n . k_> a
esebeni	E . s E . b_< E . n i
esebenzisa	E . s E . b_< E . n z i . s a
esefike	E . s E . f i . k_> E
esekhohlo	E . s E . k_h O . K O
esembindini	E . s E . m b_< i . n d i . n i
esendleleni	E . s E . n K\ E . l E . n i
esenzela	E . s E . n z E . l a
esethekweni	E . s E . t_h E . k_> w E . n i
esetyenziswa	E . s E . c_> E . n z i . s w a
eshedini	E . S E . d i . n i
eshowe	E . S O . w E
eshushu	E . S u . S u
esi	E . s i
esibalulekileyo	E . s i . b_< a . l u . l E . k_> i . l E . j O
esibhakabhakeni	E . s i . b_h a . k_> a . b_h a . k_> E . n i
eside	E . s i . d E
esihla	E . s i . K a
esihlabathini	E . s i . K a . b_< a . t_h i . n i
esihle	E . s i . K E
esikhulu	E . s i . k_h u . l u
esikhundleni	E . s i . k_h u . n K\ E . n i
esikolweni	E . s i . k_> O . l w E . n i
esimandla	E . s i . m a . n K\ a
esinamandla	E . s i . n a . m a . n K\ a
esincinci	E . s i . n |\ i . n |\ i
esingamandla	E . s i . N g a . m a . n K\ a
esingu	E . s i . N g u
esinokuninzi	E . s i . n O . k_> u . n i . n z i
esintywiliselayo	E . s i . n . c_> w i . l i . s E . l a . j O
esinye	E . s i . J E
esiphakamileyo	E . s i . p_h a . k_> a . m i . l E . j O
esiphakathi	E . s i . p_h a . k_> a . t_h i
esiphekwe	E . s i . p_h E . k_> w E
esiphezu	E . s i . p_h E . z u
esiphezulu	E . s i . p_h E . z u . l u
esiphuma	E . s i . p_h u . m a
esisishunqu	E . s i . s i . S u . n !\ u
esiswini	E . s i . s w i . n i
esitalatweni	E . s i . t_> a . l a . t_> w E . n i
esithathwini	E . s i . t_h a . t_h w i . n i
esithi	E . s i . t_h i
esithile	E . s i . t_h i . l E
esitsho	E . s i . tS_h O
esitya	E . s i . c_> a
esivulekileyo	E . s i . v u . l E . k_> i . l E . j O
esiwa	E . s i . w a
esixekweni	E . s i . |\|\ E . k_> w E . n i
esixhenxe	E . s i . |\|\_h E . n |\|\ E
esiya	E . s i . j a
esizikithini	E . s i . z i . k_> i . t_h i . n i
esizwe	E . s i . z w E
eso	E . s O
esolatha	E . s O . l a . t_h a
esondela	E . s O . n d E . l a
esondliwa	E . s O . n K\ i . w a
esonka	E . s O . n . k_> a
esonwabelwa	E . s O . n w a . b_< E . l w a
esuka	E . s u . k_> a
eswiti	E . s w i . t_> i
eteksini	E . t_> E k_> . s i . n i
ethafeni	E . t_h a . f E . n i
ethafenii	E . t_h a . f E . n i . i
ethakazelela	E . t_h a . k_> a . z E . l E . l a
ethambekileyo	E . t_h a . m b_< E . k_> i . l E . j O
ethe	E . t_h E
ethekwini	E . t_h E . k_> w i . n i
ethilini	E . t_h i . l i . n i
ethimla	E . t_h i . m . l a
ethini	E . t_h i . n i
ethu	E . t_h u
ethwele	E . t_h w E . l E
ethwethwa	E . t_h w E . t_h w a
etsala	E . ts_> a . l a
etshisayo	E . tS_h i . s a . j O
etsho	E . tS_h O
etsiba	E . ts_> i . b_< a
etsibela	E . ts_> i . b_< E . l a
etye	E . c_> E
etyebileyo	E . c_> E . b_< i . l E . j O
etyesini	E . c_> E . s i . n i
etyiwayo	E . c_> i . w a . j O
evathiswe	E . v a . t_h i . s w E
evela	E . v E . l a
evelisa	E . v E . l i . s a
evuka	E . v u . k_> a
evuthuza	E . v u . t_h u . z a
evuthuzayo	E . v u . t_h u . z a . j O
evuza	E . v u . z a
ewe	E . w E
ewela	E . w E . l a
ewuhlweza	E . w u . K w E . z a
exesha	E . |\|\ E . S a
exhalabile	E . |\|\_h a . l a . b_< i . l E
eya	E . j a
eyabuza	E . j a . b_< u . z a
eyadini	E . j a . d i . n i
eyakhiwe	E . j a . k_h i . w E
eyamashumi	E . j a . m a . S u . m i
eyayihleli	E . j a . j i . K E . l i
eyayingavunywanga	E . j a . j i . N g a . v u . J w a . N g a
eyayingonwabisanga	E . j a . j i . N g O . n w a . b_< i . s a . N g a
eyayinxibe	E . j a . j i . n |\|\ i . b_< E
eyayisechibini	E . j a . j i . s E . |\_h i . b_< i . n i
eyayisetyenziswa	E . j a . j i . s E . c_> E . n z i . s w a
eyayisina	E . j a . j i . s i . n a
eyayiwutsibile	E . j a . j i . w u . ts_> i . b_< i . l E
eyazo	E . j a . z O
eyenzekileyo	E . j E . n z E . k_> i . l E . j O
eyenziwe	E . j E . n z i . w E
eyenziweyo	E . j E . n z i . w E . j O
eyi	E . j i
eyilumkisa	E . j i . l u . m k_> i . s a
eyilwe	E . j i . l w E
eyokhangela	E . j O . k_h a . N g E . l a
eyomela	E . j O . m E . l a
eyomileyo	E . j O . m i . l E . j O
eyomisiweyo	E . j O . m i . s i . w E . j O
eyona	E . j O . n a
eyoyikayo	E . j O . j i . k_> a . j O
eza	E . z a
ezandleni	E . z a . n K\ E . n i
ezantsi	E . z a . n ts_> i
ezazinencindi	E . z a . z i . n E . n |\ i . n d i
ezaziseludongeni	E . z a . z i . s E . l u . d O . N g E . n i
ezenza	E . z E . n z a
ezi	E . z i
ezibomvu	E . z i . b_< O . m . v u
ezibukhali	E . z i . b_< u . k_h a . l i
ezicambalalayo	E . z i . |\ a . m b_< a . l a . l a . j O
ezidlulileyo	E . z i . K\ u . l i . l E . j O
ezifanayo	E . z i . f a . n a . j O
ezifundiweyo	E . z i . f u . n d i . w E . j O
ezigqityiweyo	E . z i . !\g_0 i . c_> i . w E . j O
ezigutyiweyo	E . z i . g u . c_> i . w E . j O
ezihamba	E . z i . h a . m b_< a
ezikhatyelwa	E . z i . k_h a . c_> E . l w a
ezilandela	E . z i . l a . n d E . l a
ezili	E . z i . l i
eziliqela	E . z i . l i . !\ E . l a
ezilungileyo	E . z i . l u . N g i . l E . j O
ezimandla	E . z i . m a . n K\ a
ezimbalwa	E . z i . m b_< a . l w a
ezimbini	E . z i . m b_< i . n i
ezimnandi	E . z i . m n a . n d i
ezina	E . z i . n a
ezine	E . z i . n E
ezineempondo	E . z i . n E . E . m p_> O . n d O
ezinempembelelo	E . z i . n E . m p_> E . m b_< E . l E . l O
ezingabanjelwanga	E . z i . N g a . b_< a . n dZ E . l w a . N g a
ezingamakhulu	E . z i . N g a . m a . k_h u . l u
ezingamashumi	E . z i . N g a . m a . S u . m i
ezingaphantsi	E . z i . N g a . p_h a . n ts_> i
ezingcangcazelayo	E . z i . N |\g_0 a . N |\g_0 a . z E . l a . j O
ezingcongolweni	E . z i . N |\g_0 O . N g O . l w E . n i
ezinhlanu	E . z i . n K a . n u
ezininzi	E . z i . n i . n z i
ezinkulu	E . z i . n . k_> u . l u
ezinobuzaza	E . z i . n O . b_< u . z a . z a
ezinomtsalane	E . z i . n O . m . ts_> a . l a . n E
ezintandathu	E . z i . n t_> a . n d a . t_h u
ezintathu	E . z i . n t_> a . t_h u
ezintlanu	E . z i . n tK_> a . n u
ezinye	E . z i . J E
ezinzulwini	E . z i . n z u . l w i . n i
ezipalini	E . z i . p_> a . l i . n i
eziphakamileyo	E . z i . p_h a . k_> a . m i . l E . j O
eziqingqiweyo	E . z i . !\ i . N !\g_0 i . w E . j O
ezisemhlabeni	E . z i . s E . m K a . b_< E . n i
ezisemyezweni	E . z i . s E . m j E . z w E . n i
ezisezantsi	E . z i . s E . z a . n ts_> i
eziswiti	E . z i . s w i . t_> i
ezithele	E . z i . t_h E . l E
ezithile	E . z i . t_h i . l E
ezivela	E . z i . v E . l a
ezixabisekileyo	E . z i . |\|\ a . b_< i . s E . k_> i . l E . j O
ezixelele	E . z i . |\|\ E . l E . l E
eziyi	E . z i . j i
eziyikeyiki	E . z i . j i . k_> E . j i . k_> i
eziziintloko	E . z i . z i . i . n tK_> O . k_> O
ezo	E . z O
ezotywe	E . z O . c_> w E
ezuba	E . z u . b_< a
fama	f a . m a
feleng	f E . l E . N
fifa	f i . f a
frentshi	f r E . n tS_> i
froome	f r O . O . m E
fudo	f u . d O
fundayo	f u . n d a . j O
futhi	f u . t_h i
futshane	f u . tS_h a . n E
gabuza	g a . b_< u . z a
gala	g a . l a
galela	g a . l E . l a
goli	g O . l i
golozayo	g O . l O . z a . j O
gopane	g O . p_> a . n E
gqi	!\g_0 i
gqibani	!\g_0 i . b_< a . n i
gqithisa	!\g_0 i . t_h i . s a
gqolo	!\g_0 O . l O
gquba	!\g_0 u . b_< a
gquzu	!\g_0 u . z u
gxebe	|\|\g_0 E . b_< E
gxezu	|\|\g_0 E . z u
gxididi	|\|\g_0 i . d i . d i
hagu	h a . g u
hamba	h a . m b_< a
haruki	h a . r u . k_> i
hawayi	h a . w a . j i
hawu	h a . w u
hayi	h a . j i
hhe	h E
hlabathi	K a . b_< a . t_h i
hlala	K a . l a
hlanjiwe	K a . n dZ i . w E
hlanu	K a . n u
hlaselani	K a . s E . l a . n i
hlasi	K a . s i
hlathikazi	K a . t_h i . k_> a . z i
hlatshwayo	K a . tS_h w a . j O
hlobo	K O . b_< O
hlongwa	K O . N g w a
hlosi	K O . s i
hlwazayo	K w a . z a . j O
hmm	m m
ho	h O
i	i
ialfabhethi	i . a l . f a . b_h E . t_h i
ibala	i . b_< a . l a
ibaleka	i . b_< a . l E . k_> a
ibali	i . b_< a . l i
ibalisa	i . b_< a . l i . s a
ibambekile	i . b_< a . m b_< E . k_> i . l E
ibanga	i . b_< a . N g a
ibe	i . b_< E
ibetha	i . b_< E . t_h a
ibethe	i . b_< E . t_h E
ibethwe	i . b_< E . t_h w E
ibhanti	i . b_h a . n t_> i
ibhayisekile	i . b_h a . j i . s E . k_> i . l E
ibhedi	i . b_h E . d i
ibhere	i . b_h E . r E
ibhiskithi	i . b_h i . s k_> i . t_h i
ibhola	i . b_h O . l a
ibhotile	i . b_h O . t_> i . l E
ibifuneka	i . b_< i . f u . n E . k_> a
ibiliphupha	i . b_< i . l i . p_h u . p_h a
ibingumlawuli	i . b_< i . N g u . m . l a . w u . l i
ibingumyili	i . b_< i . N g u . m j i . l i
ibizwa	i . b_< i . z w a
iblakfesi	i . b_< l a k_> . f E . s i
ibonakala	i . b_< O . n a . k_> a . l a
ibonisa	i . b_< O . n i . s a
ibrashi	i . b_< r a . S i
ibulaleka	i . b_< u . l a . l E . k_> a
ibunzi	i . b_< u . n z i
icebo	i . |\ E . b_< O
icilikishe	i . |\ i . l i . k_> i . S E
icotha	i . |\ O . t_h a
idadela	i . d a . d E . l a
idemokhrasi	i . d E . m O . k_h r a . s i
idiski	i . d i . s k_> i
idlale	i . K\ a . l E
idolophu	i . d O . l O . p_h u
idonki	i . d O . n . k_> i
idutyulwe	i . d u . c_> u . l w E
idyasi	i . J\ a . s i
ifama	i . f a . m a
ifasikoti	i . f a . s i . k_> O . t_> i
ifike	i . f i . k_> E
iflegi	i . f l E . g i
ifoto	i . f O . t_> O
ifudumele	i . f u . d u . m E . l E
ifundisa	i . f u . n d i . s a
ifune	i . f u . n E
igalufu	i . g a . l u . f u
igama	i . g a . m a
iglasi	i . g l a . s i
igqotsile	i . !\g_0 O . ts_> i . l E
igquba	i . !\g_0 u . b_< a
igquma	i . !\g_0 u . m a
igqwethekile	i . !\g_0 w E . t_h E . k_> i . l E
igumbi	i . g u . m b_< i
igunyabantu	i . g u . J a . b_< a . n t_> u
igwangqa	i . g w a . N !\g_0 a
igwinya	i . g w i . J a
igxekwa	i . |\|\g_0 E . k_> w a
ihafu	i . h a . f u
ihagu	i . h a . g u
ihambe	i . h a . m b_< E
ihashe	i . h a . S E
ihlafuna	i . K a . f u . n a
ihlobo	i . K O . b_< O
ihobe	i . h O . b_< E
ii	i . i
iibhola	i . i . b_h O . l a
iigusha	i . i . g u . S a
iijini	i . i . dZ i . n i
iikepusi	i . i . k_> E . p_> u . s i
iikhilomitha	i . i . k_h i . l O . m i . t_h a
iiklabhu	i . i . k_> l a . b_h u
iikowuti	i . i . k_> O . w u . t_> i
iilokhwe	i . i . l O . k_h w E
iilori	i . i . l O . r i
iimazi	i . i . m a . z i
iimbotyi	i . i . m b_< O . c_> i
iimeko	i . i . m E . k_> O
iimengo	i . i . m E . N g O
iimpahla	i . i . m p_> a . K a
iimpawu	i . i . m p_> a . w u
iimpazamo	i . i . m p_> a . z a . m O
iimpiko	i . i . m p_> i . k_> O
iimpuku	i . i . m p_> u . k_> u
iimpundu	i . i . m p_> u . n d u
iimvula	i . i . m . v u . l a
iincwadi	i . i . n |\ w a . d i
iindevu	i . i . n d E . v u
iindlulamthi	i . i . n K\ u . l a . m t_h i
iindondo	i . i . n d O . n d O
iingcango	i . i . N |\g_0 a . N g O
iingqekembe	i . i . N !\g_0 E . k_> E . m b_< E
iingwenya	i . i . N g w E . J a
iingxelo	i . i . N |\|\g_0 E . l O
iingxolo	i . i . N |\|\g_0 O . l O
iinkonzo	i . i . n . k_> O . n z O
iinkozo	i . i . n . k_> O . z O
iinkumbulo	i . i . n . k_> u . m b_< u . l O
iintaka	i . i . n t_> a . k_> a
iintakazana	i . i . n t_> a . k_> a . z a . n a
iintlantsi	i . i . n tK_> a . n ts_> i
iintlanzi	i . i . n tK_> a . n z i
iintlobo	i . i . n tK_> O . b_< O
iintloko	i . i . n tK_> O . k_> O
iintothoviyane	i . i . n t_> O . t_h O . v i . j a . n E
iintshatsheli	i . i . n tS_> a . tS_h E . l i
iintsimbi	i . i . n ts_> i . m b_< i
iintsuku	i . i . n ts_> u . k_> u
iintuku	i . i . n t_> u . k_> u
iintyatyambo	i . i . n . c_> a . c_> a . m b_< O
iinwele	i . i . n w E . l E
iiprojekthi	i . i . p_> r O . dZ E k_> . t_h i
iiteksi	i . i . t_> E k_> . s i
iivekana	i . i . v E . k_> a . n a
iiveki	i . i . v E . k_> i
iiyunithi	i . i . j u . n i . t_h i
ijelo	i . dZ E . l O
ijem	i . dZ E . m
ijezi	i . dZ E . z i
ijikeleza	i . dZ i . k_> E . l E . z a
ikakhulu	i . k_> a . k_h u . l u
ikati	i . k_> a . t_> i
ikayiti	i . k_> a . j i . t_> i
ikepusi	i . k_> E . p_> u . s i
ikhadi	i . k_h a . d i
ikhaphetshu	i . k_h a . p_h E . tS_h u
ikharikyulam	i . k_h a . r i . k_> j u . l a . m
ikhaya	i . k_h a . j a
ikhephu	i . k_h E . p_h u
ikhethini	i . k_h E . t_h i . n i
ikhitshi	i . k_h i . tS_h i
ikhokelele	i . k_h O . k_> E . l E . l E
ikhona	i . k_h O . n a
ikonkriti	i . k_> O . n . kx_> i . t_> i
ikulandele	i . k_> u . l a . n d E . l E
ilambile	i . l a . m b_< i . l E
ilanga	i . l a . N g a
ileta	i . l E . t_> a
iliso	i . l i . s O
ilitye	i . l i . c_> E
iliza	i . l i . z a
ilizwe	i . l i . z w E
ilizwi	i . l i . z w i
ilori	i . l O . r i
ilula	i . l u . l a
imali	i . m a . l i
iman'	i . m a . n
imbewu	i . m b_< E . w u
imbovane	i . m b_< O . v a . n E
imbulu	i . m b_< u . l u
imela	i . m E . l a
imfazwe	i . m . f a . z w E
imfuyo	i . m . f u . j O
imhlophe	i . m K O . p_h E
imidlalo	i . m i . K\ a . l O
imifanekiso	i . m i . f a . n E . k_> i . s O
imihla	i . m i . K a
imilomo	i . m i . l O . m O
imimoya	i . m i . m O . j a
imin	i . m i . n
iminenga	i . m i . n E . N g a
imingxuma	i . m i . N |\|\g_0 u . m a
imingxunya	i . m i . N |\|\g_0 u . J a
imini	i . m i . n i
iminqwazi	i . m i . n !\ w a . z i
iminwe	i . m i . n w E
iminyaka	i . m i . J a . k_> a
imisho	i . m i . S O
imithi	i . m i . t_h i
imiyalelo	i . m i . j a . l E . l O
imka	i . m k_> a
imke	i . m k_> E
imnandi	i . m n a . n d i
imoski	i . m O . s k_> i
imoto	i . m O . t_> O
impahla	i . m p_> a . K a
impangele	i . m p_> a . N g E . l E
impendle	i . m p_> E . n K\ E
impiliso	i . m p_> i . l i . s O
impilo	i . m p_> i . l O
impumelelo	i . m p_> u . m E . l E . l O
impumlo	i . m p_> u . m . l O
imva	i . m . v a
imvubu	i . m . v u . b_< u
imvula	i . m . v u . l a
indaba	i . n d a . b_< a
indawo	i . n d a . w O
indebe	i . n d E . b_< E
indima	i . n d i . m a
indiphulule	i . n d i . p_h u . l u . l E
indiya	i . n d i . j a
indlela	i . n K\ E . l a
indlovu	i . n K\ O . v u
indoda	i . n d O . d a
indodana	i . n d O . d a . n a
induli	i . n d u . l i
inenekazi	i . n E . n E . k_> a . z i
inetha	i . n E . t_h a
ingaba	i . N g a . b_< a
ingakhathazana	i . N g a . k_h a . t_h a . z a . n a
ingakumbi	i . N g a . k_> u . m b_< i
inganxibanga	i . N g a . n |\|\ i . b_< a . N g a
ingaqondi	i . N g a . !\ O . n d i
ingathi	i . N g a . t_h i
ingawaseli	i . N g a . w a . s E . l i
ingazalani	i . N g a . z a . l a . n i
ingca	i . N |\g_0 a
ingena	i . N g E . n a
ingobozi	i . N g O . b_< O . z i
ingoma	i . N g O . m a
ingonyama	i . N g O . J a . m a
ingqanga	i . N !\g_0 a . N g a
ingqayi	i . N !\g_0 a . j i
ingqele	i . N !\g_0 E . l E
ingqikelelo	i . N !\g_0 i . k_> E . l E . l O
ingququ	i . N !\g_0 u . !\ u
ingwamza	i . N g w a . m z a
ingwenya	i . N g w E . J a
ingxaki	i . N |\|\g_0 a . k_> i
ingxenye	i . N |\|\g_0 E . J E
ingxolo	i . N |\|\g_0 O . l O
ingxowa	i . N |\|\g_0 O . w a
ingxwabangxwaba	i . N |\|\g_0 w a . b_< a . N |\|\g_0 w a . b_< a
inhlanhla	i . n K a . n K a
inhlonipho	i . n K O . n i . p_h O
inkampani	i . n . k_> a . m p_> a . n i
inkawu	i . n . k_> a . w u
inkohlakalo	i . n . k_> O . K a . k_> a . l O
inkokheli	i . n . k_> O . k_h E . l i
inkomfa	i . n . k_> O . m . f a
inkululeko	i . n . k_> u . l u . l E . k_> O
inkundla	i . n . k_> u . n K\ a
inkungu	i . n . k_> u . N g u
inkunzi	i . n . k_> u . n z i
inkwenkwezi	i . n . k_> w E . n . k_> w E . z i
inkxaso	i . n |\|\ a . s O
inoba	i . n O . b_< a
inoboya	i . n O . b_< O . j a
inokuba	i . n O . k_> u . b_< a
inomgqobho	i . n O . m . !\g_0 O . b_h O
inqaku	i . n !\ a . k_> u
inqanawe	i . n !\ a . n a . w E
inqwelo	i . n !\ w E . l O
intaba	i . n t_> a . b_< a
intaka	i . n t_> a . k_> a
intakazana	i . n t_> a . k_> a . z a . n a
intambo	i . n t_> a . m b_< O
inthanethi	i . n t_h a . n E . t_h i
intlanganiso	i . n tK_> a . N g a . n i . s O
intlanhla	i . n tK_> a . n K a
intlanzi	i . n tK_> a . n z i
intle	i . n tK_> E
intlithekileyo	i . n tK_> i . t_h E . k_> i . l E . j O
intliziyo	i . n tK_> i . z i . j O
intloko	i . n tK_> O . k_> O
intlonipho	i . n tK_> O . n i . p_h O
into	i . n t_> O
intombazana	i . n t_> O . m b_< a . z a . n a
intombazanana	i . n t_> O . m b_< a . z a . n a . n a
intonga	i . n t_> O . N g a
intsasa	i . n ts_> a . s a
intshontsho	i . n tS_> O . n tS_> O
intsimi	i . n ts_> i . m i
intsini	i . n ts_> i . n i
intyantyambo	i . n . c_> a . n . c_> a . m b_< O
intyatyambo	i . n . c_> a . c_> a . m b_< O
inxaniwe	i . n |\|\ a . n i . w E
inxibe	i . n |\|\ i . b_< E
inyama	i . J a . m a
inyanga	i . J a . N g a
inyaniso	i . J a . n i . s O
inyhobha	i . J_h O . b_h a
inzolo	i . n z O . l O
iorenji	i . O . r E . n dZ i
ipati	i . p_> a . t_> i
ipayi	i . p_> a . j i
ipenti	i . p_> E . n t_> i
iphelelwe	i . p_h E . l E . l w E
iphi	i . p_h i
iphini	i . p_h i . n i
ipiyano	i . p_> i . j a . n O
iplanga	i . p_> l a . N g a
ipomakazi	i . p_> O . m a . k_> a . z i
iprojekthi	i . p_> r O . dZ E k_> . t_h i
iqanda	i . !\ a . n d a
iqela	i . !\ E . l a
iqhina	i . !\_h i . n a
iqhinga	i . !\_h i . N g a
iqhotswe	i . !\_h O . ts_> w E
iqhuba	i . !\_h u . b_< a
iqhwalela	i . !\_h w a . l E . l a
iqhwaqhwazelisa	i . !\_h w a . !\_h w a . z E . l i . s a
iqondo	i . !\ O . n d O
ireferensi	i . r E . f E . r E . n s i
iresipi	i . r E . s i . p_> i
irhamba	i . x a . m b_< a
irherheba	i . x E . x E . b_< a
iringi	i . r i . N g i
isamente	i . s a . m E . n t_> E
isandi	i . s a . n d i
isandla	i . s a . n K\ a
isenyeliso	i . s E . J E . l i . s O
isenzela	i . s E . n z E . l a
isesandleni	i . s E . s a . n K\ E . n i
isethembiso	i . s E . t_h E . m b_< i . s O
isetyenziswe	i . s E . c_> E . n z i . s w E
isezintlungwini	i . s E . z i . n tK_> u . N g w i . n i
ishedyuli	i . S E . J\ u . l i
ishiya	i . S i . j a
isi	i . s i
isicelo	i . s i . |\ E . l O
isichotho	i . s i . |\_h O . t_h O
isiciko	i . s i . |\ i . k_> O
isidlo	i . s i . K\ O
isifa	i . s i . f a
isifuba	i . s i . f u . b_< a
isifundo	i . s i . f u . n d O
isigebenga	i . s i . g E . b_< E . N g a
isigqibo	i . s i . !\g_0 i . b_< O
isikhafu	i . s i . k_h a . f u
isikhalo	i . s i . k_h a . l O
isikhitshane	i . s i . k_h i . tS_h a . n E
isikhova	i . s i . k_h O . v a
isikhukukazi	i . s i . k_h u . k_> u . k_> a . z i
isikhululo	i . s i . k_h u . l u . l O
isikolo	i . s i . k_> O . l O
isilingi	i . s i . l i . N g i
isiloli	i . s i . l O . l i
isilumkiso	i . s i . l u . m k_> i . s O
isingci	i . s i . N |\g_0 i
isingqala	i . s i . N !\g_0 a . l a
isinxibo	i . s i . n |\|\ i . b_< O
isiphako	i . s i . p_h a . k_> O
isipho	i . s i . p_h O
isiqabu	i . s i . !\ a . b_< u
isisombululo	i . s i . s O . m b_< u . l u . l O
isitalato	i . s i . t_> a . l a . t_> O
isitediyamu	i . s i . t_> E . d i . j a . m u
isithembiso	i . s i . t_h E . m b_< i . s O
isithonga	i . s i . t_h O . N g a
isithukuthezi	i . s i . t_h u . k_> u . t_h E . z i
isithunzi	i . s i . t_h u . n z i
isitishi	i . s i . t_> i . S i
isitshingitshane	i . s i . tS_h i . N g i . tS_h a . n E
isityebi	i . s i . c_> E . b_< i
isityu	i . s i . c_> u
isiva	i . s i . v a
isixeko	i . s i . |\|\ E . k_> O
isohlwayo	i . s O . K w a . j O
isothuka	i . s O . t_h u . k_> a
isoyika	i . s O . j i . k_> a
isuka	i . s u . k_> a
itakane	i . t_> a . k_> a . n E
itasi	i . t_> a . s i
ithanga	i . t_h a . N g a
ithatha	i . t_h a . t_h a
ithathwa	i . t_h a . t_h w a
ithe	i . t_h E
ithile	i . t_h i . l E
ithoba	i . t_h O . b_< a
ithontsi	i . t_h O . n ts_> i
itonamente	i . t_> O . n a . m E . n t_> E
itshampeyini	i . tS_h a . m p_> E . j i . n i
itshintshi	i . tS_h i . n tS_> i
itshiswa	i . tS_h i . s w a
itumeleng	i . t_> u . m E . l E . N
itya	i . c_> a
ityeli	i . c_> E . l i
ityhafa	i . c_h a . f a
ityhafile	i . c_h a . f i . l E
ityuwa	i . c_> u . w a
ivumba	i . v u . m b_< a
ixabiso	i . |\|\ a . b_< i . s O
ixesha	i . |\|\ E . S a
ixhala	i . |\|\_h a . l a
ixhego	i . |\|\_h E . g O
ixhegokazi	i . |\|\_h E . g O . k_> a . z i
ixolo	i . |\|\ O . l O
ixwebe	i . |\|\ w E . b_< E
iya	i . j a
iyadi	i . j a . d i
iyafika	i . j a . f i . k_> a
iyahexa	i . j a . h E . |\|\ a
iyalana	i . j a . l a . n a
iyaliva	i . j a . l i . v a
iyaphaphatheka	i . j a . p_h a . p_h a . t_h E . k_> a
iyaqhathwa	i . j a . !\_h a . t_h w a
iye	i . j E
iyeyama	i . j E . j a . m a
iyho	i . j O
iyikholwe	i . j i . k_h O . l w E
iyimpendulo	i . j i . m p_> E . n d u . l O
iyindyikityha	i . j i . n . J\ i . k_> i . c_h a
iyokugada	i . j O . k_> u . g a . d a
iyona	i . j O . n a
iyunifomu	i . j u . n i . f O . m u
iza	i . z a
izakubanceda	i . z a . k_> u . b_< a . n |\ E . d a
izalele	i . z a . l E . l E
izambreli	i . z a . m . b_< r E . l i
izandla	i . z a . n K\ a
izembe	i . z E . m b_< E
izibalo	i . z i . b_< a . l O
izibuyisele	i . z i . b_< u . j i . s E . l E
izicithi	i . z i . |\ i . t_h i
izidlele	i . z i . K\ E . l E
izihlwele	i . z i . K w E . l E
iziketi	i . z i . k_> E . t_> i
izikhundla	i . z i . k_h u . n K\ a
izilwanyana	i . z i . l w a . J a . n a
izinambuzane	i . z i . n a . m b_< u . z a . n E
izincwadi	i . z i . n |\ w a . d i
izindaba	i . z i . n d a . b_< a
izinga	i . z i . N g a
izinkcwe	i . z i . n |\ w E
izinsuku	i . z i . n s u . k_> u
izinto	i . z i . n t_> O
iziphelo	i . z i . p_h E . l O
iziqhakancu	i . z i . !\_h a . k_> a . n |\ u
iziqhoboshi	i . z i . !\_h O . b_< O . S i
izisa	i . z i . s a
izityalo	i . z i . c_> a . l O
iziza	i . z i . z a
izokusetyenziswa	i . z O . k_> u . s E . c_> E . n z i . s w a
januwari	dZ a . n u . w a . r i
jem	dZ E . m
jikela	dZ i . k_> E . l a
jikelele	dZ i . k_> E . l E . l E
joja	dZ O . dZ a
jonga	dZ O . N g a
jongani	dZ O . N g a . n i
junja	dZ u . n dZ a
ka	k_> a
kadyakalashe	k_> a . J\ a . k_> a . l a . S E
kakade	k_> a . k_> a . d E
kakhulu	k_> a . k_h u . l u
kakhulwana	k_> a . k_h u . l w a . n a
kakubi	k_> a . k_> u . b_< i
kakuhle	k_> a . k_> u . K E
kaloku	k_> a . l O . k_> u
kalusizi	k_> a . l u . s i . z i
kamalume	k_> a . m a . l u . m E
kamnandi	k_> a . m n a . n d i
kamsinyane	k_> a . m s i . J a . n E
kamuzu	k_> a . m u . z u
kananjalo	k_> a . n a . n dZ a . l O
kancane	k_> a . n |\ a . n E
kancinci	k_> a . n |\ i . n |\ i
kangaka	k_> a . N g a . k_> a
kangangoko	k_> a . N g a . N g O . k_> O
kanobom	k_> a . n O . b_< O . m
kanye	k_> a . J E
kapa	k_> a . p_> a
karuru	k_> a . r u . r u
katata	k_> a . t_> a . t_> a
katatomkhulu	k_> a . t_> a . t_> O . m k_h u . l u
kati	k_> a . t_> i
katlehong	k_> a . tK_> E . h O . N
kato	k_> a . t_> O
ke	k_> E
kenya	k_> E . J a
keti	k_> E . t_> i
kgalema	kx_> a . l E . m a
kgomotso	kx_> O . m O . ts_> O
khadija	k_h a . d i . dZ a
khalai	k_h a . l a . i
khange	k_h a . N g E
khangela	k_h a . N g E . l a
khawuleza	k_h a . w u . l E . z a
khawumjonge	k_h a . w u . m . dZ O . N g E
khetha	k_h E . t_h a
khethukuhle	k_h E . t_h u . k_> u . K E
khona	k_h O . n a
khova	k_h O . v a
khozi	k_h O . z i
khozo	k_h O . z O
khuboni	k_h u . b_< O . n i
khula	k_h u . l a
khumbula	k_h u . m b_< u . l a
khumbulani	k_h u . m b_< u . l a . n i
khwela	k_h w E . l a
khwelani	k_h w E . l a . n i
ko	k_> O
kocango	k_> O . |\ a . N g O
kocingo	k_> O . |\ i . N g O
kodwa	k_> O . d w a
koena	k_> O . E . n a
kohambo	k_> O . h a . m b_< O
kokhuseleko	k_> O . k_h u . s E . l E . k_> O
koko	k_> O . k_> O
kokuba	k_> O . k_> u . b_< a
kokubizwa	k_> O . k_> u . b_< i . z w a
kokuchatshazelwa	k_> O . k_> u . |\_h a . tS_h a . z E . l w a
kokucinga	k_> O . k_> u . |\ i . N g a
kokulahlekelwa	k_> O . k_> u . l a . K E . k_> E . l w a
kokulinda	k_> O . k_> u . l i . n d a
kokuphi	k_> O . k_> u . p_h i
kokuqala	k_> O . k_> u . !\ a . l a
kokwenyaniso	k_> O . k_> w E . J a . n i . s O
koloni	k_> O . l O . n i
koluntu	k_> O . l u . n t_> u
kolwimi	k_> O . l w i . m i
komdibaniso	k_> O . m d i . b_< a . n i . s O
komgxobhozo	k_> O . m . |\|\g_0 O . b_h O . z O
komhlaba	k_> O . m K a . b_< a
komhlahli	k_> O . m K a . K i
komjelo	k_> O . m . dZ E . l O
komlambo	k_> O . m . l a . m b_< O
kommi	k_> O . m . m i
komthi	k_> O . m t_h i
konwatyelwa	k_> O . n w a . c_> E . l w a
konwatyelwe	k_> O . n w a . c_> E . l w E
kopa	k_> O . p_> a
kowabo	k_> O . w a . b_< O
krwaqu	kx_> w a . !\ u
ku	k_> u
kuba	k_> u . b_< a
kubabukeli	k_> u . b_< a . b_< u . k_> E . l i
kubande	k_> u . b_< a . n d E
kubekho	k_> u . b_< E . k_h O
kubiza	k_> u . b_< i . z a
kubo	k_> u . b_< O
kubonisa	k_> u . b_< O . n i . s a
kuboniswa	k_> u . b_< O . n i . s w a
kubuso	k_> u . b_< u . s O
kubusuku	k_> u . b_< u . s u . k_> u
kucaca	k_> u . |\ a . |\ a
kucace	k_> u . |\ a . |\ E
kudada	k_> u . d a . d a
kudala	k_> u . d a . l a
kudale	k_> u . d a . l E
kude	k_> u . d E
kudlalwa	k_> u . K\ a . l w a
kudlule	k_> u . K\ u . l E
kufa	k_> u . f a
kufika	k_> u . f i . k_> a
kufike	k_> u . f i . k_> E
kufumile	k_> u . f u . m i . l E
kufuneka	k_> u . f u . n E . k_> a
kufuphi	k_> u . f u . p_h i
kufutshane	k_> u . f u . tS_h a . n E
kugqatso	k_> u . !\g_0 a . ts_> O
kugqiba	k_> u . !\g_0 i . b_< a
kugqityezelwa	k_> u . !\g_0 i . c_> E . z E . l w a
kuhamba	k_> u . h a . m b_< a
kuhlala	k_> u . K a . l a
kuhlamba	k_> u . K a . m b_< a
kuhlangana	k_> u . K a . N g a . n a
kuhleka	k_> u . K E . k_> a
kuka	k_> u . k_> a
kukhale	k_> u . k_h a . l E
kukhanyise	k_> u . k_h a . J i . s E
kukho	k_> u . k_h O
kukhokelele	k_> u . k_h O . k_> E . l E . l E
kukhonomoya	k_> u . k_h O . n O . m O . j a
kukohlwaya	k_> u . k_> O . K w a . j a
kukubanegugu	k_> u . k_> u . b_< a . n E . g u . g u
kukulamba	k_> u . k_> u . l a . m b_< a
kukulila	k_> u . k_> u . l i . l a
kukuncedisa	k_> u . k_> u . n |\ E . d i . s a
kukungqubana	k_> u . k_> u . N !\g_0 u . b_< a . n a
kukwaba	k_> u . k_> w a . b_< a
kukwenze	k_> u . k_> w E . n z E
kulapho	k_> u . l a . p_h O
kulenzela	k_> u . l E . n z E . l a
kulicoca	k_> u . l i . |\ O . |\ a
kulikhangela	k_> u . l i . k_h a . N g E . l a
kulinda	k_> u . l i . n d a
kulo	k_> u . l O
kuloliwe	k_> u . l O . l i . w E
kulomdlalo	k_> u . l O . m K\ a . l O
kulomyezo	k_> u . l O . m j E . z O
kuloo	k_> u . l O . O
kuluhlaza	k_> u . l u . K a . z a
kuluhlu	k_> u . l u . K u
kulungile	k_> u . l u . N g i . l E
kulungileyo	k_> u . l u . N g i . l E . j O
kuluphumelela	k_> u . l u . p_h u . m E . l E . l a
kum	k_> u . m
kumahlathi	k_> u . m a . K a . t_h i
kumanzi	k_> u . m a . n z i
kumaqela	k_> u . m a . !\ E . l a
kumawabo	k_> u . m a . w a . b_< O
kumazwe	k_> u . m a . z w E
kumdlalo	k_> u . m K\ a . l O
kumdyarho	k_> u . m . J\ a . x O
kumenzakalo	k_> u . m E . n z a . k_> a . l O
kumfana	k_> u . m . f a . n a
kumjikelo	k_> u . m . dZ i . k_> E . l O
kumka	k_> u . m k_> a
kumkani	k_> u . m k_> a . n i
kumnandi	k_> u . m n a . n d i
kumnika	k_> u . m n i . k_> a
kumnyango	k_> u . m J a . N g O
kumoya	k_> u . m O . j a
kumthengi	k_> u . m t_h E . N g i
kumthungo	k_> u . m t_h u . N g O
kumtyelela	k_> u . m . c_> E . l E . l a
kumyezo	k_> u . m j E . z O
kumzi	k_> u . m z i
kuna	k_> u . n a
kunabo	k_> u . n a . b_< O
kunambitheka	k_> u . n a . m b_< i . t_h E . k_> a
kunawakho	k_> u . n a . w a . k_h O
kunawe	k_> u . n a . w E
kunceda	k_> u . n |\ E . d a
kundipha	k_> u . n d i . p_h a
kungakugcina	k_> u . N g a . k_> u . |\g_0 i . n a
kunganjani	k_> u . N g a . n dZ a . n i
kungaye	k_> u . N g a . j E
kungcono	k_> u . N |\g_0 O . n O
kungekho	k_> u . N g E . k_h O
kungekudala	k_> u . N g E . k_> u . d a . l a
kungena	k_> u . N g E . n a
kungenxa	k_> u . N g E . n |\|\ a
kunikela	k_> u . n i . k_> E . l a
kunjalo	k_> u . n dZ a . l O
kunyaka	k_> u . J a . k_> a
kunye	k_> u . J E
kunyulo	k_> u . J u . l O
kunyulwa	k_> u . J u . l w a
kupapashwa	k_> u . p_> a . p_> a . S w a
kupha	k_> u . p_h a
kuphela	k_> u . p_h E . l a
kuphele	k_> u . p_h E . l E
kuphumelela	k_> u . p_h u . m E . l E . l a
kuqala	k_> u . !\ a . l a
kuqhuba	k_> u . !\_h u . b_< a
kuqhubeka	k_> u . !\_h u . b_< E . k_> a
kuqhubela	k_> u . !\_h u . b_< E . l a
kuqoqosho	k_> u . !\ O . !\ O . S O
kuquka	k_> u . !\ u . k_> a
kurhaxwa	k_> u . x a . |\|\ w a
kusanda	k_> u . s a . n d a
kusasa	k_> u . s a . s a
kusebenza	k_> u . s E . b_< E . n z a
kusekwe	k_> u . s E . k_> w E
kusela	k_> u . s E . l a
kushushu	k_> u . S u . S u
kusiba	k_> u . s i . b_< a
kusini	k_> u . s i . n i
kusitshintshisela	k_> u . s i . tS_h i . n tS_> i . s E . l a
kuso	k_> u . s O
kusompempe	k_> u . s O . m p_> E . m p_> E
kutheni	k_> u . t_h E . n i
kuthetha	k_> u . t_h E . t_h a
kuthi	k_> u . t_h i
kutitshala	k_> u . t_> i . tS_h a . l a
kutsha	k_> u . tS_h a
kutsho	k_> u . tS_h O
kutshona	k_> u . tS_h O . n a
kutsiba	k_> u . ts_> i . b_< a
kutya	k_> u . c_> a
kutyhilekile	k_> u . c_h i . l E . k_> i . l E
kuwa	k_> u . w a
kuwe	k_> u . w E
kuwo	k_> u . w O
kuwumisa	k_> u . w u . m i . s a
kuxa	k_> u . |\|\ a
kuya	k_> u . j a
kuyabanda	k_> u . j a . b_< a . n d a
kuyakubakho	k_> u . j a . k_> u . b_< a . k_h O
kuyakuna	k_> u . j a . k_> u . n a
kuye	k_> u . j E
kuyenza	k_> u . j E . n z a
kuyibona	k_> u . j i . b_< O . n a
kuyicula	k_> u . j i . |\ u . l a
kuyifumana	k_> u . j i . f u . m a . n a
kuyikhetha	k_> u . j i . k_h E . t_h a
kuyinyaniso	k_> u . j i . J a . n i . s O
kuyiphumelela	k_> u . j i . p_h u . m E . l E . l a
kuyitya	k_> u . j i . c_> a
kuyo	k_> u . j O
kuza	k_> u . z a
kuze	k_> u . z E
kuziintsuku	k_> u . z i . i . n ts_> u . k_> u
kuziiyure	k_> u . z i . i . j u . r E
kuzimela	k_> u . z i . m E . l a
kuzo	k_> u . z O
kuzona	k_> u . z O . n a
kwa	k_> w a
kwabakho	k_> w a . b_< a . k_h O
kwabakhweli	k_> w a . b_< a . k_h w E . l i
kwabanye	k_> w a . b_< a . J E
kwabasetyhini	k_> w a . b_< a . s E . c_h i . n i
kwabekwa	k_> w a . b_< E . k_> w a
kwabo	k_> w a . b_< O
kwade	k_> w a . d E
kwadlula	k_> w a . K\ u . l a
kwafefezwa	k_> w a . f E . f E . z w a
kwafuneka	k_> w a . f u . n E . k_> a
kwakamsinya	k_> w a . k_> a . m s i . J a
kwakamsinyane	k_> w a . k_> a . m s i . J a . n E
kwakhe	k_> w a . k_h E
kwakhona	k_> w a . k_h O . n a
kwakhula	k_> w a . k_h u . l a
kwakubiyelwe	k_> w a . k_> u . b_< i . j E . l w E
kwakuhlala	k_> w a . k_> u . K a . l a
kwakukho	k_> w a . k_> u . k_h O
kwakumcaphukisa	k_> w a . k_> u . m . |\ a . p_h u . k_> i . s a
kwakungekho	k_> w a . k_> u . N g E . k_h O
kwakunyanzelekile	k_> w a . k_> u . J a . n z E . l E . k_> i . l E
kwakunye	k_> w a . k_> u . J E
kwakusele	k_> w a . k_> u . s E . l E
kwakuvakala	k_> w a . k_> u . v a . k_> a . l a
kwakuxhonywe	k_> w a . k_> u . |\|\_h O . J w E
kwakuzole	k_> w a . k_> u . z O . l E
kwalengwenya	k_> w a . l E . N g w E . J a
kwama	k_> w a . m a
kwamahlahla	k_> w a . m a . K a . K a
kwamatyholo	k_> w a . m a . c_h O . l O
kwamehlo	k_> w a . m E . K O
kwampahla	k_> w a . m p_> a . K a
kwanamhlanje	k_> w a . n a . m K a . n dZ E
kwangaxesha	k_> w a . N g a . |\|\ E . S a
kwangexesha	k_> w a . N g E . |\|\ E . S a
kwangoko	k_> w a . N g O . k_> O
kwangoku	k_> w a . N g O . k_> u
kwanzima	k_> w a . n z i . m a
kwaphela	k_> w a . p_h E . l a
kwaphuma	k_> w a . p_h u . m a
kwasematyholweni	k_> w a . s E . m a . c_h O . l w E . n i
kwashiyeka	k_> w a . S i . j E . k_> a
kwasongelwa	k_> w a . s O . N g E . l w a
kwathathwa	k_> w a . t_h a . t_h w a
kwathi	k_> w a . t_h i
kwatsho	k_> w a . tS_h O
kwavakala	k_> w a . v a . k_> a . l a
kwavela	k_> w a . v E . l a
kwavula	k_> w a . v u . l a
kwawo	k_> w a . w O
kwaye	k_> w a . j E
kwayi	k_> w a . j i
kwayo	k_> w a . j O
kwaze	k_> w a . z E
kwazulu	k_> w a . z u . l u
kwe	k_> w E
kwebhedi	k_> w E . b_h E . d i
kwebhodi	k_> w E . b_h O . d i
kwedemokhrasi	k_> w E . d E . m O . k_h r a . s i
kwedlelo	k_> w E . K\ E . l O
kwedolophu	k_> w E . d O . l O . p_h u
kweengwenya	k_> w E . E . N g w E . J a
kweentupha	k_> w E . E . n t_> u . p_h a
kweenyosi	k_> w E . E . J O . s i
kweevekana	k_> w E . E . v E . k_> a . n a
kwefasitela	k_> w E . f a . s i . t_> E . l a
kwehlabathi	k_> w E . K a . b_< a . t_h i
kwekhawuntari	k_> w E . k_h a . w u . n t_> a . r i
kwelanga	k_> w E . l a . N g a
kwelayisensi	k_> w E . l a . j i . s E . n s i
kweli	k_> w E . l i
kwelizwe	k_> w E . l i . z w E
kwemifanekiso	k_> w E . m i . f a . n E . k_> i . s O
kwemini	k_> w E . m i . n i
kweminyaka	k_> w E . m i . J a . k_> a
kwengca	k_> w E . N |\g_0 a
kwengeniso	k_> w E . N g E . n i . s O
kwengqondo	k_> w E . N !\g_0 O . n d O
kwentloko	k_> w E . n tK_> O . k_> O
kwenye	k_> w E . J E
kwenziwa	k_> w E . n z i . w a
kweqonga	k_> w E . !\ O . N g a
kwesibini	k_> w E . s i . b_< i . n i
kwesingci	k_> w E . s i . N |\g_0 i
kwesitalato	k_> w E . s i . t_> a . l a . t_> O
kwetyholo	k_> w E . c_h O . l O
kwexesha	k_> w E . |\|\ E . S a
kwexeshana	k_> w E . |\|\ E . S a . n a
kweyi	k_> w E . j i
kwezi	k_> w E . z i
kwezindlu	k_> w E . z i . n K\ u
kwezinsuku	k_> w E . z i . n s u . k_> u
kwezinye	k_> w E . z i . J E
kwezorhwebo	k_> w E . z O . x w E . b_< O
kwi	k_> w i
kwibala	k_> w i . b_< a . l a
kwibali	k_> w i . b_< a . l i
kwibhafu	k_> w i . b_h a . f u
kwibhanti	k_> w i . b_h a . n t_> i
kwicala	k_> w i . |\ a . l a
kwichibi	k_> w i . |\_h i . b_< i
kwidlelo	k_> w i . K\ E . l O
kwidolophukazi	k_> w i . d O . l O . p_h u . k_> a . z i
kwifama	k_> w i . f a . m a
kwigunjana	k_> w i . g u . n dZ a . n a
kwihemisfiye	k_> w i . h E . m i . s i . f i . j E
kwihlathi	k_> w i . K a . t_h i
kwiholide	k_> w i . h O . l i . d E
kwiikhilomitha	k_> w i . i . k_h i . l O . m i . t_h a
kwiimitha	k_> w i . i . m i . t_h a
kwiindawo	k_> w i . i . n d a . w O
kwiingwamza	k_> w i . i . N g w a . m z a
kwiinkulungwane	k_> w i . i . n . k_> u . l u . N g w a . n E
kwiintsasa	k_> w i . i . n ts_> a . s a
kwiintsuku	k_> w i . i . n ts_> u . k_> u
kwiintyatyambo	k_> w i . i . n . c_> a . c_> a . m b_< O
kwiipenalthi	k_> w i . i . p_> E . n a l . t_h i
kwikhebhini	k_> w i . k_h E . b_h i . n i
kwikhilomitha	k_> w i . k_h i . l O . m i . t_h a
kwikomityi	k_> w i . k_> O . m i . c_> i
kwilixa	k_> w i . l i . |\|\ a
kwimalana	k_> w i . m a . l a . n a
kwimbali	k_> w i . m b_< a . l i
kwimeko	k_> w i . m E . k_> O
kwimfono	k_> w i . m . f O . n O
kwimiboniso	k_> w i . m i . b_< O . n i . s O
kwimidlalo	k_> w i . m i . K\ a . l O
kwiminyaka	k_> w i . m i . J a . k_> a
kwimo	k_> w i . m O
kwimpelaveki	k_> w i . m p_> E . l a . v E . k_> i
kwimpuma	k_> w i . m p_> u . m a
kwindawo	k_> w i . n d a . w O
kwindebe	k_> w i . n d E . b_< E
kwindlela	k_> w i . n K\ E . l a
kwindlu	k_> w i . n K\ u
kwinjanana	k_> w i . n dZ a . n a . n a
kwinkampu	k_> w i . n . k_> a . m p_> u
kwinto	k_> w i . n t_> O
kwintolongo	k_> w i . n t_> O . l O . N g O
kwiofisi	k_> w i . O . f i . s i
kwipaki	k_> w i . p_> a . k_> i
kwipasipoti	k_> w i . p_> a . s i . p_> O . t_> i
kwiphephandaba	k_> w i . p_h E . p_h a . n d a . b_< a
kwiphondo	k_> w i . p_h O . n d O
kwiqampu	k_> w i . !\ a . m p_> u
kwiqela	k_> w i . !\ E . l a
kwisangqa	k_> w i . s a . N !\g_0 a
kwisebe	k_> w i . s E . b_< E
kwisigaba	k_> w i . s i . g a . b_< a
kwisigqibo	k_> w i . s i . !\g_0 i . b_< O
kwisikhululo	k_> w i . s i . k_h u . l u . l O
kwisingxotyana	k_> w i . s i . N |\|\g_0 O . c_> a . n a
kwisiqingatha	k_> w i . s i . !\ i . N g a . t_h a
kwisiqithi	k_> w i . s i . !\ i . t_h i
kwisitalato	k_> w i . s i . t_> a . l a . t_> O
kwitheko	k_> w i . t_h E . k_> O
kwitonamente	k_> w i . t_> O . n a . m E . n t_> E
kwixabiso	k_> w i . |\|\ a . b_< i . s O
kwixesha	k_> w i . |\|\ E . S a
kwiyure	k_> w i . j u . r E
kwizifundo	k_> w i . z i . f u . n d O
kwizihlandlo	k_> w i . z i . K a . n K\ O
kwizityu	k_> w i . z i . c_> u
kwowu	k_> w O . w u
la	l a
laa	l a . a
lababhaki	l a . b_< a . b_h a . k_> i
labalweli	l a . b_< a . l w E . l i
labantu	l a . b_< a . n t_> u
labhabha	l a . b_h a . b_h a
labona	l a . b_< O . n a
lacenga	l a . |\ E . N g a
lafika	l a . f i . k_> a
lagoduka	l a . g O . d u . k_> a
lahamba	l a . h a . m b_< a
lahlulwe	l a . K u . l w E
lakhe	l a . k_h E
lakho	l a . k_h O
lakukhohlela	l a . k_> u . k_h O . K E . l a
lakwa	l a . k_> w a
laligcwele	l a . l i . |\g_0 w E . l E
laligqats'	l a . l i . !\g_0 a ts_>
lalineentloni	l a . l i . n E . E . n tK_> O . n i
lalinxunguphele	l a . l i . n |\|\ u . N g u . p_h E . l E
lalinye	l a . l i . J E
lalisoloko	l a . l i . s O . l O . k_> O
lalivele	l a . l i . v E . l E
laliyiyizela	l a . l i . j i . j i . z E . l a
lalwatyuza	l a . l w a . c_> u . z a
lam	l a . m
lamanzi	l a . m a . n z i
lambonga	l a . m b_< O . N g a
lamboo	l a . m b_< O . O
lamnika	l a . m n i . k_> a
landela	l a . n d E . l a
langa	l a . N g a
lanqika	l a . n !\ i . k_> a
lapho	l a . p_h O
laqalisa	l a . !\ a . l i . s a
larhogela	l a . x O . g E . l a
larhubuluza	l a . x u . b_< u . l u . z a
lase	l a . s E
laso	l a . s O
lathatha	l a . t_h a . t_h a
lathi	l a . t_h i
latsho	l a . tS_h O
lawo	l a . w O
laya	l a . j a
layithi	l a . j i . t_h i
layitshonisa	l a . j i . tS_h O . n i . s a
layo	l a . j O
laza	l a . z a
laze	l a . z E
lazijula	l a . z i . dZ u . l a
lazithatha	l a . z i . t_h a . t_h a
laziwa	l a . z i . w a
le	l E
lebango	l E . b_< a . N g O
lebese	l E . b_< E . s E
leejalebisi	l E . E . dZ a . l E . b_< i . s i
legalufu	l E . g a . l u . f u
legolide	l E . g O . l i . d E
lehla	l E . K a
lekishon	l E . k_> i . S O . n
lelinye	l E . l i . J E
leliphi	l E . l i . p_h i
lelobuhlanga	l E . l O . b_< u . K a . N g a
lelona	l E . l O . n a
lema	l E . m a
lemali	l E . m a . l i
lembasa	l E . m b_< a . s a
lembulu	l E . m b_< u . l u
lemvula	l E . m . v u . l a
lendlala	l E . n K\ a . l a
lendlovu	l E . n K\ O . v u
lentetho	l E . n t_> E . t_h O
lentswela	l E . n ts_> w E . l a
lenza	l E . n z a
lephalale	l E . p_h a . l a . l E
leqela	l E . !\ E . l a
lerato	l E . r a . t_> O
lesanti	l E . s a . n t_> i
lesibhozo	l E . s i . b_h O . z O
lesidlo	l E . s i . K\ O
lesiqingatha	l E . s i . !\ i . N g a . t_h a
lesithathu	l E . s i . t_h a . t_h u
lesizwe	l E . s i . z w E
lethu	l E . t_h u
leveki	l E . v E . k_> i
leyo	l E . j O
lezemidlalo	l E . z E . m i . K\ a . l O
lezemozulu	l E . z E . m O . z u . l u
lezopolitiko	l E . z O . p_> O . l i . t_> i . k_> O
libaleka	l i . b_< a . l E . k_> a
lifuna	l i . f u . n a
ligama	l i . g a . m a
ligi	l i . g i
lihleka	l i . K E . k_> a
lijoje	l i . dZ O . dZ E
lijongise	l i . dZ O . N g i . s E
likakhetsekile	l i . k_> a . k_h E . ts_> E . k_> i . l E
likamama	l i . k_> a . m a . m a
likamnumzana	l i . k_> a . m n u . m z a . n a
likhombisa	l i . k_h O . m b_< i . s a
likhuphe	l i . k_h u . p_h E
likrelekrele	l i . kx_> E . l E . kx_> E . l E
lilanga	l i . l a . N g a
lilizwe	l i . l i . z w E
limnandi	l i . m n a . n d i
limqhwabela	l i . m . !\_h w a . b_< E . l a
lindikhumbuza	l i . n d i . k_h u . m b_< u . z a
lineenkokeli	l i . n E . E . n . k_> O . k_> E . l i
linga	l i . N g a
lingam	l i . N g a . m
linganxibanga	l i . N g a . n |\|\ i . b_< a . N g a
lingongoza	l i . N g O . N g O . z a
linxele	l i . n |\|\ E . l E
liphango	l i . p_h a . N g O
liphawula	l i . p_h a . w u . l a
liphume	l i . p_h u . m E
liqela	l i . !\ E . l a
liqondo	l i . !\ O . n d O
lisebenze	l i . s E . b_< E . n z E
lisebenzile	l i . s E . b_< E . n z i . l E
lisiya	l i . s i . j a
lisuka	l i . s u . k_> a
lithathe	l i . t_h a . t_h E
lithe	l i . t_h E
lithethayo	l i . t_h E . t_h a . j O
lithuba	l i . t_h u . b_< a
litsala	l i . ts_> a . l a
litsha	l i . tS_h a
litshintshile	l i . tS_h i . n tS_> i . l E
litswele	l i . ts_> w E . l E
livakala	l i . v a . k_> a . l a
liwa	l i . w a
liwele	l i . w E . l E
lixa	l i . |\|\ a
lixesha	l i . |\|\ E . S a
liyafundisa	l i . j a . f u . n d i . s a
lizichaza	l i . z i . |\_h a . z a
lizityela	l i . z i . c_> E . l a
lo	l O
loboya	l O . b_< O . j a
lobushushu	l O . b_< u . S u . S u
lodipo	l O . d i . p_> O
lokhenketho	l O . k_h E . n . k_> E . t_h O
lokuba	l O . k_> u . b_< a
lokubetha	l O . k_> u . b_< E . t_h a
lokucheba	l O . k_> u . |\_h E . b_< a
lokudlala	l O . k_> u . K\ a . l a
lokufundela	l O . k_> u . f u . n d E . l a
lokugqibela	l O . k_> u . !\g_0 i . b_< E . l a
lokulala	l O . k_> u . l a . l a
lokuphekela	l O . k_> u . p_h E . k_> E . l a
lokuphumelela	l O . k_> u . p_h u . m E . l E . l a
lokuqhatha	l O . k_> u . !\_h a . t_h a
lokuqokelela	l O . k_> u . !\ O . k_> E . l E . l a
lokwala	l O . k_> w a . l a
lolawulo	l O . l a . w u . l O
lolo	l O . l O
loluntu	l O . l u . n t_> u
lombathiswe	l O . m b_< a . t_h i . s w E
lombona	l O . m b_< O . n a
lomdlalo	l O . m K\ a . l O
lomfazi	l O . m . f a . z i
lomhambi	l O . m_h a . m b_< i
lomlambo	l O . m . l a . m b_< O
lomsebenz	l O . m s E . b_< E n z
lomthi	l O . m t_h i
lona	l O . n a
lonke	l O . n . k_> E
loo	l O . O
lorhwebo	l O . x w E . b_< O
lothethathethwano	l O . t_h E . t_h a . t_h E . t_h w a . n O
lothotho	l O . t_h O . t_h O
lotywala	l O . c_> w a . l a
lowo	l O . w O
luanda	l u . a . n d a
lubalulekile	l u . b_< a . l u . l E . k_> i . l E
lubandakanya	l u . b_< a . n d a . k_> a . J a
ludano	l u . d a . n O
lufana	l u . f a . n a
luhlaza	l u . K a . z a
luka	l u . k_> a
lukhula	l u . k_h u . l a
lula	l u . l a
lulu	l u . l u
lulwimi	l u . l w i . m i
lumkwana	l u . m k_> w a . n a
luntshule	l u . n tS_> u . l E
luqe	l u . !\ E
luquke	l u . !\ u . k_> E
luqwalaselwa	l u . !\ w a . l a . s E . l w a
luqwalaselwe	l u . !\ w a . l a . s E . l w E
lusizana	l u . s i . z a . n a
lusuku	l u . s u . k_> u
luthimla	l u . t_h i . m . l a
luvhengo	l u . v E . N g O
luvo	l u . v O
luvuyo	l u . v u . j O
luyaphola	l u . j a . p_h O . l a
luyatshisa	l u . j a . tS_h i . s a
luzizi	l u . z i . z i
lwabahlali	l w a . b_< a . K a . l i
lwabamba	l w a . b_< a . m b_< a
lwabeka	l w a . b_< E . k_> a
lwabemi	l w a . b_< E . m i
lwabiwomali	l w a . b_< i . w O . m a . l i
lwahlala	l w a . K a . l a
lwahleka	l w a . K E . k_> a
lwakhathazeka	l w a . k_h a . t_h a . z E . k_> a
lwakhe	l w a . k_h E
lwakho	l w a . k_h O
lwakhula	l w a . k_h u . l a
lwalufumana	l w a . l u . f u . m a . n a
lwam	l w a . m
lwamanzi	l w a . m a . n z i
lwanamhlanje	l w a . n a . m K a . n dZ E
lwantoni	l w a . n t_> O . n i
lwantywila	l w a . n . c_> w i . l a
lwaphendula	l w a . p_h E . n d u . l a
lwase	l w a . s E
lwasedolophini	l w a . s E . d O . l O . p_h i . n i
lwasenkampini	l w a . s E . n . k_> a . m p_> i . n i
lwataka	l w a . t_> a . k_> a
lwathi	l w a . t_h i
lwaya	l w a . j a
lwayo	l w a . j O
lwazi	l w a . z i
lwe	l w E
lwebhola	l w E . b_h O . l a
lwee	l w E . E
lweekharati	l w E . E . k_h a . r a . t_> i
lweembaleki	l w E . E . m b_< a . l E . k_> i
lweencwadi	l w E . E . n |\ w a . d i
lwehagu	l w E . h a . g u
lwemarike	l w E . m a . r i . k_> E
lwenqwelo	l w E . n !\ w E . l O
lwenye	l w E . J E
lwesi	l w E . s i
lwesibini	l w E . s i . b_< i . n i
lwesine	l w E . s i . n E
lweso	l w E . s O
lwezikhululo	l w E . z i . k_h u . l u . l O
lwezonyango	l w E . z O . J a . N g O
ma	m a
mabaso	m a . b_< a . s O
mabokgwane	m a . b_< O . kx_> w a . n E
madoda	m a . d O . d a
magona	m a . g O . n a
magozwe	m a . g O . z w E
mahle	m a . K E
makabiye	m a . k_> a . b_< i . j E
makahlale	m a . k_> a . K a . l E
makaringe	m a . k_> a . r i . N g E
makhosi	m a . k_h O . s i
makhulu	m a . k_h u . l u
makhwenkwe	m a . k_h w E . n . k_> w E
malahleni	m a . l a . K E . n i
malini	m a . l i . n i
malugoduke	m a . l u . g O . d u . k_> E
malunga	m a . l u . N g a
mama	m a . m a
mamela	m a . m E . l a
mamelodi	m a . m E . l O . d i
mandela	m a . n d E . l a
mandikhangele	m a . n d i . k_h a . N g E . l E
mandikugalele	m a . n d i . k_> u . g a . l E . l E
mandithi	m a . n d i . t_h i
mango	m a . N g O
mangope	m a . N g O . p_> E
manzi	m a . n z i
maseko	m a . s E . k_> O
masibe	m a . s i . b_< E
masikhangeleni	m a . s i . k_h a . N g E . l E . n i
masimxelele	m a . s i . m . |\|\ E . l E . l E
masina	m a . s i . n a
masiqubheni	m a . s i . !\ u . b_h E . n i
masiteng	m a . s i . t_> E . N
masithandaze	m a . s i . t_h a . n d a . z E
masiyiqwangqulule	m a . s i . j i . !\ w a . N !\g_0 u . l u . l E
matlaba	m a . tK_> a . b_< a
matrayivethi	m a . t_> r a . j i . v E . t_h i
matshi	m a . tS_h i
matshona	m a . tS_h O . n a
maxa	m a . |\|\ a
mayiye	m a . j i . j E
mazinyo	m a . z i . J O
mazwi	m a . z w i
mbaleki	m b_< a . l E . k_> i
mbambe	m b_< a . m b_< E
mbeki	m b_< E . k_> i
mbekile	m b_< E . k_> i . l E
mbhele	m . b_h E . l E
mboko	m b_< O . k_> O
mbongintwini	m b_< O . N g i . n t_> w i . n i
mboniso	m b_< O . n i . s O
mdali	m d a . l i
mdlalo	m K\ a . l O
mehlo	m E . K O
melika	m E . l i . k_> a
meyi	m E . j i
mfazi	m . f a . z i
mfene	m . f E . n E
mfo	m . f O
mfono	m . f O . n O
mfulwane	m . f u . l w a . n E
mfundo	m . f u . n d O
mgama	m . g a . m a
mgcini	m . |\g_0 i . n i
mgibe	m . g i . b_< E
mgqibelo	m . !\g_0 i . b_< E . l O
mgxobhozo	m . |\|\g_0 O . b_h O . z O
mhango	m_h a . N g O
mhla	m K a
mhlalutyi	m K a . l u . c_> i
mhlanga	m K a . N g a
mhlawumbi	m K a . w u . m b_< i
mhlekazi	m K E . k_> a . z i
mhlobo	m K O . b_< O
mi	m i
mibala	m i . b_< a . l a
milenzana	m i . l E . n z a . n a
mingaphi	m i . N g a . p_h i
mini	m i . n i
minti	m i . n t_> i
minyaka	m i . J a . k_> a
mjondolo	m . dZ O . n d O . l O
mkhondo	m k_h O . n d O
mkhulu	m k_h u . l u
mlambo	m . l a . m b_< O
mlilo	m . l i . l O
mna	m n a
mnenga	m n E . N g a
mngeni	m . N g E . n i
mngoma	m . N g O . m a
mntla	m . n tK_> a
mntu	m . n t_> u
mntwana	m . n t_> w a . n a
mntwanam	m . n t_> w a . n a . m
mnumzana	m n u . m z a . n a
mnyama	m J a . m a
mnye	m J E
modise	m O . d i . s E
moeketsi	m O . E . k_> E . ts_> i
mofokeng	m O . f O . k_> E . N
mogapi	m O . g a . p_> i
molo	m O . l O
monyai	m O . J a . i
mosikili	m O . s i . k_> i . l i
mota	m O . t_> a
motaung	m O . t_> a . u . N
mothusi	m O . t_h u . s i
motlanthe	m O . tK_> a . n t_h E
motsamai	m O . ts_> a . m a . i
moya	m O . j a
mpela	m p_> E . l a
mpepho	m p_> E . p_h O
mphathiswa	m p_h a . t_h i . s w a
mpho	m p_h O
mphuthukezi	m p_h u . t_h u . k_> E . z i
mpondo	m p_> O . n d O
mpondozihlanjiwe	m p_> O . n d O . z i . K a . n dZ i . w E
mpuma	m p_> u . m a
mpumalanga	m p_> u . m a . l a . N g a
mqhagi	m . !\_h a . g i
msila	m s i . l a
msinyane	m s i . J a . n E
mthatha	m t_h a . t_h a
mthetho	m t_h E . t_h O
mthi	m t_h i
mthokozisi	m t_h O . k_> O . z i . s i
mtonyama	m t_> O . J a . m a
mungomeni	m u . N g O . m E . n i
musa	m u . s a
mva	m . v a
mvakwemini	m . v a . k_> w E . m i . n i
mvavanyo	m . v a . v a . J O
mvubu	m . v u . b_< u
mvula	m . v u . l a
mvulo	m . v u . l O
mvundla	m . v u . n K\ a
mwedihanga	m w E . d i . h a . N g a
myeke	m j E . k_> E
myoli	m j O . l i
mzantsi	m z a . n ts_> i
mzi	m z i
mzuzu	m z u . z u
na	n a
nabafuduki	n a . b_< a . f u . d u . k_> i
nabantwana	n a . b_< a . n t_> w a . n a
nabazali	n a . b_< a . z a . l i
nabo	n a . b_< O
nako	n a . k_> O
nakwamanye	n a . k_> w a . m a . J E
nakwezo	n a . k_> w E . z O
nakwiintloko	n a . k_> w i . i . n tK_> O . k_> O
nale	n a . l E
naliphango	n a . l i . p_h a . N g O
nalithemba	n a . l i . t_h E . m b_< a
nam	n a . m
namachokoza	n a . m a . |\_h O . k_> O . z a
namadoda	n a . m a . d O . d a
namakhaphetshu	n a . m a . k_h a . p_h E . tS_h u
namandongomane	n a . m a . n d O . N g O . m a . n E
namanqaku	n a . m a . n !\ a . k_> u
namapolisa	n a . m a . p_> O . l i . s a
namathuba	n a . m a . t_h u . b_< a
namatyana	n a . m a . c_> a . n a
namatyholo	n a . m a . c_h O . l O
nameva	n a . m E . v a
namhlanje	n a . m K a . n dZ E
namukuru	n a . m u . k_> u . r u
nangoko	n a . N g O . k_> O
nangoku	n a . N g O . k_> u
nangona	n a . N g O . n a
nanjengoko	n a . n dZ E . N g O . k_> O
nanko	n a . n . k_> O
nantoni	n a . n t_> O . n i
nantsi	n a . n ts_> i
nantso	n a . n ts_> O
naphantsi	n a . p_h a . n ts_> i
naphezulu	n a . p_h E . z u . l u
nase	n a . s E
nasemva	n a . s E . m . v a
naso	n a . s O
natal	n a . t_> a l
natala	n a . t_> a . l a
nathi	n a . t_h i
nawe	n a . w E
nawo	n a . w O
nawomoya	n a . w O . m O . j a
nawuphi	n a . w u . p_h i
naye	n a . j E
nayile	n a . j i . l E
nayisimanga	n a . j i . s i . m a . N g a
nayo	n a . j O
nazi	n a . z i
ncanda	n |\ a . n d a
nceda	n |\ E . d a
ncedani	n |\ E . d a . n i
ncede	n |\ E . d E
ncedo	n |\ E . d O
ncinane	n |\ i . n a . n E
ndadibana	n d a . d i . b_< a . n a
ndakhuliswa	n d a . k_h u . l i . s w a
ndakukhupha	n d a . k_> u . k_h u . p_h a
ndathi	n d a . t_h i
ndatya	n d a . c_> a
ndaxelisa	n d a . |\|\ E . l i . s a
ndayilinganisa	n d a . j i . l i . N g a . n i . s a
ndebe	n d E . b_< E
ndedwa	n d E . d w a
ndenza	n d E . n z a
ndevu	n d E . v u
ndibetha	n d i . b_< E . t_h a
ndicele	n d i . |\ E . l E
ndicinga	n d i . |\ i . N g a
ndidinga	n d i . d i . N g a
ndidlala	n d i . K\ a . l a
ndifele	n d i . f E . l E
ndifumene	n d i . f u . m E . n E
ndifuna	n d i . f u . n a
ndifunda	n d i . f u . n d a
ndigqiba	n d i . !\g_0 i . b_< a
ndihombise	n d i . h O . m b_< i . s E
ndijonge	n d i . dZ O . N g E
ndikhangele	n d i . k_h a . N g E . l E
ndikrelekrele	n d i . kx_> E . l E . kx_> E . l E
ndikukholelwe	n d i . k_> u . k_h O . l E . l w E
ndikusongele	n d i . k_> u . s O . N g E . l E
ndilambile	n d i . l a . m b_< i . l E
ndilapha	n d i . l a . p_h a
ndileqa	n d i . l E . !\ a
ndilikhangele	n d i . l i . k_h a . N g E . l E
ndililahlile	n d i . l i . l a . K i . l E
ndilithandile	n d i . l i . t_h a . n d i . l E
ndiluginye	n d i . l u . g i . J E
ndilungise	n d i . l u . N g i . s E
ndim	n d i . m
ndimbi	n d i . m b_< i
ndimtswebe	n d i . m . ts_> w E . b_< E
ndinalo	n d i . n a . l O
ndinamazinyo	n d i . n a . m a . z i . J O
ndinamendu	n d i . n a . m E . n d u
ndincede	n d i . n |\ E . d E
ndineqhinga	n d i . n E . !\_h i . N g a
ndinethamsanqa	n d i . n E . t_h a . m s a . n !\ a
ndingabe	n d i . N g a . b_< E
ndingakhe	n d i . N g a . k_h E
ndingakogqitha	n d i . N g a . k_> O . !\g_0 i . t_h a
ndingakunceda	n d i . N g a . k_> u . n |\ E . d a
ndingathi	n d i . N g a . t_h i
ndingawenza	n d i . N g a . w E . n z a
ndingayenza	n d i . N g a . j E . n z a
ndingayilungisa	n d i . N g a . j i . l u . N g i . s a
ndingqinibe	n d i . N !\g_0 i . n i . b_< E
ndingu	n d i . N g u
ndingumhlobo	n d i . N g u . m K O . b_< O
ndingumtshana	n d i . N g u . m tS_h a . n a
ndini	n d i . n i
ndinokusika	n d i . n O . k_> u . s i . k_> a
ndinxunguphele	n d i . n |\|\ u . N g u . p_h E . l E
ndiphengulule	n d i . p_h E . N g u . l u . l E
ndiphindele	n d i . p_h i . n d E . l E
ndiphumelele	n d i . p_h u . m E . l E . l E
ndisebenza	n d i . s E . b_< E . n z a
ndisenamendu	n d i . s E . n a . m E . n d u
ndisisi	n d i . s i . s i
ndisitsho	n d i . s i . tS_h O
ndithathe	n d i . t_h a . t_h E
nditsho	n d i . tS_h O
ndityhafile	n d i . c_h a . f i . l E
ndive	n d i . v E
ndiwa	n d i . w a
ndixhwithe	n d i . |\|\_h w i . t_h E
ndiyabheka	n d i . j a . b_h E . k_> a
ndiyabona	n d i . j a . b_< O . n a
ndiyacinga	n d i . j a . |\ i . N g a
ndiyakholwa	n d i . j a . k_h O . l w a
ndiyakukubona	n d i . j a . k_> u . k_> u . b_< O . n a
ndiyamcingela	n d i . j a . m . |\ i . N g E . l a
ndiyasifuna	n d i . j a . s i . f u . n a
ndiyawuva	n d i . j a . w u . v a
ndiyaxolisa	n d i . j a . |\|\ O . l i . s a
ndiyayiva	n d i . j a . j i . v a
ndiye	n d i . j E
ndiyeka	n d i . j E . k_> a
ndiyeyona	n d i . j E . j O . n a
ndiyokuhlala	n d i . j O . k_> u . K a . l a
ndiyokuphefumla	n d i . j O . k_> u . p_h E . f u . m . l a
ndiza	n d i . z a
ndizakuhamba	n d i . z a . k_> u . h a . m b_< a
ndizelwe	n d i . z E . l w E
ndizithengele	n d i . z i . t_h E . N g E . l E
ndizoqala	n d i . z O . !\ a . l a
ndlebe	n K\ E . b_< E
ndlela	n K\ E . l a
ndleleni	n K\ E . l E . n i
ndlovu	n K\ O . v u
ndlulamthi	n K\ u . l a . m t_h i
ndoda	n d O . d a
ndodwa	n d O . d w a
ndomelele	n d O . m E . l E . l E
nduli	n d u . l i
ndulula	n d u . l u . l a
ne	n E
nebhayisekile	n E . b_h a . j i . s E . k_> i . l E
necebo	n E . |\ E . b_< O
nedinala	n E . d i . n a . l a
nee	n E . E
neebhola	n E . E . b_h O . l a
neebhotile	n E . E . b_h O . t_> i . l E
neeblawuzi	n E . E . b_< l a . w u . z i
needolophu	n E . E . d O . l O . p_h u
neekati	n E . E . k_> a . t_> i
neekhemikhali	n E . E . k_h E . m i . k_h a . l i
neemarula	n E . E . m a . r u . l a
neemvula	n E . E . m . v u . l a
neemvulana	n E . E . m . v u . l a . n a
neendudumo	n E . E . n d u . d u . m O
neengalo	n E . E . N g a . l O
neentaka	n E . E . n t_> a . k_> a
neentsimbi	n E . E . n ts_> i . m b_< i
neentsuku	n E . E . n ts_> u . k_> u
neentyatyambo	n E . E . n . c_> a . c_> a . m b_< O
neenyoka	n E . E . J O . k_> a
neenzipho	n E . E . n z i . p_h O
neeplastiki	n E . E . p_> l a . s t_> i . k_> i
neevoti	n E . E . v O . t_> i
negwegwe	n E . g w E . g w E
nehagu	n E . h a . g u
nekhephu	n E . k_h E . p_h u
nelanga	n E . l a . N g a
neli	n E . l i
neliblowu	n E . l i . b_< l O . w u
nelimangalisayo	n E . l i . m a . N g a . l i . s a . j O
nelimdaka	n E . l i . m d a . k_> a
nelinye	n E . l i . J E
nelirhwexayo	n E . l i . x w E . |\|\ a . j O
nemagi	n E . m a . g i
nembulu	n E . m b_< u . l u
nemigqomo	n E . m i . !\g_0 O . m O
nemilenze	n E . m i . l E . n z E
nemimoya	n E . m i . m O . j a
nemincili	n E . m i . n |\ i . l i
nemithetho	n E . m i . t_h E . t_h O
nemitshizo	n E . m i . tS_h i . z O
nempangele	n E . m p_> a . N g E . l E
nempilo	n E . m p_> i . l O
nemvula	n E . m . v u . l a
nencinane	n E . n |\ i . n a . n E
nenciniba	n E . n |\ i . n i . b_< a
nendawo	n E . n d a . w O
nendlela	n E . n K\ E . l a
nengqele	n E . N !\g_0 E . l E
nengxaki	n E . N |\|\g_0 a . k_> i
nenja	n E . n dZ a
nenkosikazi	n E . n . k_> O . s i . k_> a . z i
nenkukuma	n E . n . k_> u . k_> u . m a
nenkungu	n E . n . k_> u . N g u
nenkxaso	n E . n |\|\ a . s O
nentombazana	n E . n t_> O . m b_< a . z a . n a
nentsimbi	n E . n ts_> i . m b_< i
nenye	n E . J E
neplanga	n E . p_> l a . N g a
neqampu	n E . !\ a . m p_> u
neqela	n E . !\ E . l a
neqhinga	n E . !\_h i . N g a
neringi	n E . r i . N g i
nesichotho	n E . s i . |\_h O . t_h O
nesikhokelo	n E . s i . k_h O . k_> E . l O
nesinamoni	n E . s i . n a . m O . n i
nesinye	n E . s i . J E
nesiphango	n E . s i . p_h a . N g O
nesishiyagalolunye	n E . s i . S i . j a . g a . l O . l u . J E
nesisu	n E . s i . s u
nesithambileyo	n E . s i . t_h a . m b_< i . l E . j O
nesivumelwano	n E . s i . v u . m E . l w a . n O
neso	n E . s O
nethontsi	n E . t_h O . n ts_> i
neyehagu	n E . j E . h a . g u
nezichotho	n E . z i . |\_h O . t_h O
nezihlalo	n E . z i . K a . l O
nezihlangu	n E . z i . K a . N g u
nezincinane	n E . z i . n |\ i . n a . n E
nezinye	n E . z i . J E
nezishushu	n E . z i . S u . S u
nezitya	n E . z i . c_> a
nezoondidi	n E . z O . O . n d i . d i
ngabantu	N g a . b_< a . n t_> u
ngabazali	N g a . b_< a . z a . l i
ngakho	N g a . k_h O
ngakuyo	N g a . k_> u . j O
ngale	N g a . l E
ngalelo	N g a . l E . l O
ngalo	N g a . l O
ngaloo	N g a . l O . O
ngama	N g a . m a
ngamabali	N g a . m a . b_< a . l i
ngamabhongo	N g a . m a . b_h O . N g O
ngamacala	N g a . m a . |\ a . l a
ngamalungu	N g a . m a . l u . N g u
ngamandla	N g a . m a . n K\ a
ngamanqaku	N g a . m a . n !\ a . k_> u
ngamanye	N g a . m a . J E
ngamanzi	N g a . m a . n z i
ngamaphupho	N g a . m a . p_h u . p_h O
ngamaqhinga	N g a . m a . !\_h i . N g a
ngamaqondo	N g a . m a . !\ O . n d O
ngamaxesha	N g a . m a . |\|\ E . S a
ngamehlo	N g a . m E . K O
ngamendu	N g a . m E . n d u
ngaminazana	N g a . m i . n a . z a . n a
ngamnye	N g a . m J E
ngamxhelo	N g a . m . |\|\_h E . l O
ngani	N g a . n i
nganye	N g a . J E
ngaphakathi	N g a . p_h a . k_> a . t_h i
ngaphambili	N g a . p_h a . m b_< i . l i
ngaphandle	N g a . p_h a . n K\ E
ngaphantsi	N g a . p_h a . n ts_> i
ngaphaya	N g a . p_h a . j a
ngaphesheya	N g a . p_h E . S E . j a
ngaphezu	N g a . p_h E . z u
ngaphezulu	N g a . p_h E . z u . l u
ngasekhaya	N g a . s E . k_h a . j a
ngasemgxobhozweni	N g a . s E . m . |\|\g_0 O . b_h O . z w E . n i
ngasemva	N g a . s E . m . v a
ngasinye	N g a . s i . J E
ngathi	N g a . t_h i
ngawo	N g a . w O
ngayo	N g a . j O
ngazo	N g a . z O
ngcono	N |\g_0 O . n O
ngcu	N |\g_0 u
nge	N g E
ngebali	N g E . b_< a . l i
ngebhola	N g E . b_h O . l a
ngedazini	N g E . d a . z i . n i
ngee	N g E . E
ngeegusha	N g E . E . g u . S a
ngeempuphu	N g E . E . m p_> u . p_h u
ngeendlebe	N g E . E . n K\ E . b_< E
ngeenkqubo	N g E . E . n !\ u . b_< O
ngeentloko	N g E . E . n tK_> O . k_> O
ngeentsimbi	N g E . E . n ts_> i . m b_< i
ngeenyawo	N g E . E . J a . w O
ngeepanalthi	N g E . E . p_> a . n a l . t_h i
ngeepenalthi	N g E . E . p_> E . n a l . t_h i
ngeepenti	N g E . E . p_> E . n t_> i
ngegolide	N g E . g O . l i . d E
ngekhokhonathi	N g E . k_h O . k_h O . n a . t_h i
ngekhowudi	N g E . k_h O . w u . d i
ngelaphu	N g E . l a . p_h u
ngeli	N g E . l i
ngelinye	N g E . l i . J E
ngelishwa	N g E . l i . S w a
ngelizwi	N g E . l i . z w i
ngelo	N g E . l O
ngembono	N g E . m b_< O . n O
ngemigca	N g E . m i . |\g_0 a
ngemincili	N g E . m i . n |\ i . l i
ngeminwe	N g E . m i . n w E
ngemoto	N g E . m O . t_> O
ngempumelelo	N g E . m p_> u . m E . l E . l O
ngempumlo	N g E . m p_> u . m . l O
ngemva	N g E . m . v a
ngendithe	N g E . n d i . t_h E
ngendlela	N g E . n K\ E . l a
ngenene	N g E . n E . n E
ngengubo	N g E . N g u . b_< O
ngenkukuma	N g E . n . k_> u . k_> u . m a
ngenqaku	N g E . n !\ a . k_> u
ngentloko	N g E . n tK_> O . k_> O
ngentsasa	N g E . n ts_> a . s a
ngentsimbi	N g E . n ts_> i . m b_< i
ngenxa	N g E . n |\|\ a
ngenye	N g E . J E
ngepaseji	N g E . p_> a . s E . dZ i
ngephanyazo	N g E . p_h a . J a . z O
ngephunga	N g E . p_h u . N g a
ngephupho	N g E . p_h u . p_h O
ngeribhoni	N g E . r i . b_h O . n i
ngesandla	N g E . s a . n K\ a
ngesantya	N g E . s a . n . c_> a
ngesi	N g E . s i
ngesidlo	N g E . s i . K\ O
ngesihlwele	N g E . s i . K w E . l E
ngesikhalo	N g E . s i . k_h a . l O
ngesikhathi	N g E . s i . k_h a . t_h i
ngesikrakra	N g E . s i . kx_> a . kx_> a
ngesinizi	N g E . s i . n i . z i
ngesiqingatha	N g E . s i . !\ i . N g a . t_h a
ngesixingaxinga	N g E . s i . |\|\ i . N g a . |\|\ i . N g a
ngeswekile	N g E . s w E . k_> i . l E
ngethuba	N g E . t_h u . b_< a
ngetshiki	N g E . tS_h i . k_> i
ngeveki	N g E . v E . k_> i
ngewuyiphethe	N g E . w u . j i . p_h E . t_h E
ngexesha	N g E . |\|\ E . S a
ngeyona	N g E . j O . n a
ngezandla	N g E . z a . n K\ a
ngezibane	N g E . z i . b_< a . n E
ngezinti	N g E . z i . n t_> i
ngezityalo	N g E . z i . c_> a . l O
ngezizwe	N g E . z i . z w E
nginginya	N g i . N g i . J a
nginikhohlisile	N g i . n i . k_h O . K i . s i . l E
ngo	N g O
ngoba	N g O . b_< a
ngobo	N g O . b_< O
ngobu	N g O . b_< u
ngobuchule	N g O . b_< u . |\_h u . l E
ngobude	N g O . b_< u . d E
ngobuhlanga	N g O . b_< u . K a . N g a
ngobusuku	N g O . b_< u . s u . k_> u
ngocingo	N g O . |\ i . N g O
ngocoselelo	N g O . |\ O . s E . l E . l O
ngohlobo	N g O . K O . b_< O
ngokhuseleko	N g O . k_h u . s E . l E . k_> O
ngoko	N g O . k_> O
ngokongezelekileyo	N g O . k_> O . N g E . z E . l E . k_> i . l E . j O
ngokothuka	N g O . k_> O . t_h u . k_> a
ngoku	N g O . k_> u
ngokuba	N g O . k_> u . b_< a
ngokubala	N g O . k_> u . b_< a . l a
ngokubaleka	N g O . k_> u . b_< a . l E . k_> a
ngokubancinci	N g O . k_> u . b_< a . n |\ i . n |\ i
ngokubanzi	N g O . k_> u . b_< a . n z i
ngokuchasene	N g O . k_> u . |\_h a . s E . n E
ngokufika	N g O . k_> u . f i . k_> a
ngokufundwa	N g O . k_> u . f u . n d w a
ngokugqibeleleyo	N g O . k_> u . !\g_0 i . b_< E . l E . l E . j O
ngokuhamba	N g O . k_> u . h a . m b_< a
ngokuhlwanje	N g O . k_> u . K w a . n dZ E
ngokuka	N g O . k_> u . k_> a
ngokukhawuleza	N g O . k_> u . k_h a . w u . l E . z a
ngokukrokrisayo	N g O . k_> u . kx_> O . kx_> i . s a . j O
ngokulinganayo	N g O . k_> u . l i . N g a . n a . j O
ngokungathi	N g O . k_> u . N g a . t_h i
ngokungqiba	N g O . k_> u . N !\g_0 i . b_< a
ngokungxama	N g O . k_> u . N |\|\g_0 a . m a
ngokungxolayo	N g O . k_> u . N |\|\g_0 O . l a . j O
ngokunika	N g O . k_> u . n i . k_> a
ngokunzulu	N g O . k_> u . n z u . l u
ngokupheleleyo	N g O . k_> u . p_h E . l E . l E . j O
ngokuphikisana	N g O . k_> u . p_h i . k_> i . s a . n a
ngokuqinisekileyo	N g O . k_> u . !\ i . n i . s E . k_> i . l E . j O
ngokusekelwe	N g O . k_> u . s E . k_> E . l w E
ngokusemthethweni	N g O . k_> u . s E . m t_h E . t_h w E . n i
ngokuthe	N g O . k_> u . t_h E
ngokutyhafa	N g O . k_> u . c_h a . f a
ngokuxhumela	N g O . k_> u . |\|\_h u . m E . l a
ngokuye	N g O . k_> u . j E
ngokuzama	N g O . k_> u . z a . m a
ngokuzethemba	N g O . k_> u . z E . t_h E . m b_< a
ngokuzika	N g O . k_> u . z i . k_> a
ngokuzolileyo	N g O . k_> u . z O . l i . l E . j O
ngokwaneleyo	N g O . k_> w a . n E . l E . j O
ngokwangoku	N g O . k_> w a . N g O . k_> u
ngokwaso	N g O . k_> w a . s O
ngokwekhangaru	N g O . k_> w E . k_h a . N g a . r u
ngokwenene	N g O . k_> w E . n E . n E
ngokwenza	N g O . k_> w E . n z a
ngokwethuka	N g O . k_> w E . t_h u . k_> a
ngolo	N g O . l O
ngolonwabo	N g O . l O . n w a . b_< O
ngolwesi	N g O . l w E . s i
ngombhaki	N g O . m . b_h a . k_> i
ngomhla	N g O . m K a
ngomnwe	N g O . m n w E
ngomnye	N g O . m J E
ngomqolo	N g O . m . !\ O . l O
ngomsebenzi	N g O . m s E . b_< E . n z i
ngomsindo	N g O . m s i . n d O
ngomso	N g O . m s O
ngomthi	N g O . m t_h i
ngomtsi	N g O . m . ts_> i
ngomxube	N g O . m . |\|\ u . b_< E
ngononophelo	N g O . n O . n O . p_h E . l O
ngonyaka	N g O . J a . k_> a
ngonyama	N g O . J a . m a
ngorhatya	N g O . x a . c_> a
ngosuku	N g O . s u . k_> u
ngowe	N g O . w E
ngowuphi	N g O . w u . p_h i
ngqekembe	N !\g_0 E . k_> E . m b_< E
ngqesho	N !\g_0 E . S O
ngu	N g u
ngubani	N g u . b_< a . n i
nguchwephetsha	N g u . |\_h w E . p_h E . tS_h a
ngulube	N g u . l u . b_< E
ngumbutho	N g u . m b_< u . t_h O
ngumdlalo	N g u . m K\ a . l O
ngumfanekiso	N g u . m . f a . n E . k_> i . s O
ngumfazi	N g u . m . f a . z i
ngumgama	N g u . m . g a . m a
ngumgcini	N g u . m . |\g_0 i . n i
ngumhlobo	N g u . m K O . b_< O
ngumkhosi	N g u . m k_h O . s i
ngumntwana	N g u . m . n t_> w a . n a
ngumqhubi	N g u . m . !\_h u . b_< i
ngumsindo	N g u . m s i . n d O
ngumzobo	N g u . m z O . b_< O
ngumzukulwana	N g u . m z u . k_> u . l w a . n a
ngutata	N g u . t_> a . t_> a
nguzana	N g u . z a . n a
ngwamza	N g w a . m z a
ngwe	N g w E
ngwenya	N g w E . J a
ngxolo	N |\|\g_0 O . l O
nhlanhla	n K a . n K a
nhlapho	n K a . p_h O
nhlapo	n K a . p_> O
nhlawulo	n K a . w u . l O
nidlale	n i . K\ a . l E
nifundisa	n i . f u . n d i . s a
nijonge	n i . dZ O . N g E
ningaxhalabi	n i . N g a . |\|\_h a . l a . b_< i
ningazidli	n i . N g a . z i . K\ i
nini	n i . n i
niphinde	n i . p_h i . n d E
niqhubeke	n i . !\_h u . b_< E . k_> E
nisibhalela	n i . s i . b_h a . l E . l a
niyigqibile	n i . j i . !\g_0 i . b_< i . l E
niyokudlala	n i . j O . k_> u . K\ a . l a
niza	n i . z a
nizingenise	n i . z i . N g E . n i . s E
nizizilwanyana	n i . z i . z i . l w a . J a . n a
nja	n dZ a
njalo	n dZ a . l O
njani	n dZ a . n i
nje	n dZ E
njengantoni	n dZ E . N g a . n t_> O . n i
njengawam	n dZ E . N g a . w a . m
njengebhaloni	n dZ E . N g E . b_h a . l O . n i
njengeka	n dZ E . N g E . k_> a
njengeklabhu	n dZ E . N g E . k_> l a . b_h u
njengeliya	n dZ E . N g E . l i . j a
njengelungu	n dZ E . N g E . l u . N g u
njengendawo	n dZ E . N g E . n d a . w O
njengendlunkulu	n dZ E . N g E . n K\ u . n . k_> u . l u
njengenye	n dZ E . N g E . J E
njengoko	n dZ E . N g O . k_> O
njengokona	n dZ E . N g O . k_> O . n a
njengomncedisi	n dZ E . N g O . m . n |\ E . d i . s i
njikalanga	n dZ i . k_> a . l a . N g a
njingalwazi	n dZ i . N g a . l w a . z i
njongo	n dZ O . N g O
nkawu	n . k_> a . w u
nkhatha	n . k_h a . t_h a
nkosazana	n . k_> O . s a . z a . n a
nkosi	n . k_> O . s i
nkosikazi	n . k_> O . s i . k_> a . z i
nkqi	n !\ i
nkqo	n !\ O
nkwana	n . k_> w a . n a
nkwazi	n . k_> w a . z i
nkwenkwe	n . k_> w E . n . k_> w E
nkxii	n |\|\ i . i
nneentsimbi	n . n E . E . n ts_> i . m b_< i
no	n O
nobabini	n O . b_< a . b_< i . n i
nobhaka	n O . b_h a . k_> a
nobobudala	n O . b_< O . b_< u . d a . l a
nobumanzi	n O . b_< u . m a . n z i
nobunkokeli	n O . b_< u . n . k_> O . k_> E . l i
nocingo	n O . |\ i . N g O
nococeko	n O . |\ O . |\ E . k_> O
nogolide	n O . g O . l i . d E
nohambo	n O . h a . m b_< O
nokhuphiswano	n O . k_h u . p_h i . s w a . n O
nokuba	n O . k_> u . b_< a
nokubaleka	n O . k_> u . b_< a . l E . k_> a
nokubhala	n O . k_> u . b_h a . l a
nokubuyiselwa	n O . k_> u . b_< u . j i . s E . l w a
nokufuma	n O . k_> u . f u . m a
nokugxumagxuma	n O . k_> u . |\|\g_0 u . m a . |\|\g_0 u . m a
nokuhlaliswa	n O . k_> u . K a . l i . s w a
nokujoja	n O . k_> u . dZ O . dZ a
nokukhutshwa	n O . k_> u . k_h u . tS_h w a
nokukukhulula	n O . k_> u . k_> u . k_h u . l u . l a
nokulawula	n O . k_> u . l a . w u . l a
nokunciphisa	n O . k_> u . n |\ i . p_h i . s a
nokupeyinta	n O . k_> u . p_> E . j i . n t_> a
nokutyala	n O . k_> u . c_> a . l a
nokuwela	n O . k_> u . w E . l a
nokuxoxa	n O . k_> u . |\|\ O . |\|\ a
nokuyigqiba	n O . k_> u . j i . !\g_0 i . b_< a
nolondolozo	n O . l O . n d O . l O . z O
nolwandle	n O . l w a . n K\ E
nolwaphulo	n O . l w a . p_h u . l O
nomalume	n O . m a . l u . m E
nomama	n O . m a . m a
nomatse	n O . m a . ts_> E
nomhlaba	n O . m K a . b_< a
nomlomo	n O . m . l O . m O
nomnqwazi	n O . m . n !\ w a . z i
nomnyama	n O . m J a . m a
nomnye	n O . m J E
nomoya	n O . m O . j a
nomphakathi	n O . m p_h a . k_> a . t_h i
nomthi	n O . m t_h i
nomvula	n O . m . v u . l a
nonkungu	n O . n . k_> u . N g u
nonxano	n O . n |\|\ a . n O
noodyakalashe	n O . O . J\ a . k_> a . l a . S E
noonobumba	n O . O . n O . b_< u . m b_< a
noqeqesho	n O . !\ E . !\ E . S O
nosana	n O . s a . n a
nosiba	n O . s i . b_< a
notshintsho	n O . tS_h i . n tS_> O
notyani	n O . c_> a . n i
novavanyo	n O . v a . v a . J O
novuyo	n O . v u . j O
nqola	n !\ O . l a
nqwa	n !\ w a
nqwelo	n !\ w E . l O
ntaka	n t_> a . k_> a
ntatu	n t_> a . t_> u
ntlanu	n tK_> a . n u
ntlawulo	n tK_> a . w u . l O
ntlonipho	n tK_> O . n i . p_h O
nto	n t_> O
ntofontofo	n t_> O . f O . n t_> O . f O
ntoni	n t_> O . n i
ntshangase	n tS_> a . N g a . s E
ntshatsheli	n tS_> a . tS_h E . l i
ntsho	n tS_> O
ntsholongwane	n tS_> O . l O . N g w a . n E
ntshona	n tS_> O . n a
ntuku	n t_> u . k_> u
nyama	J a . m a
nyana	J a . n a
nyatama	J a . t_> a . m a
nyathi	J a . t_h i
nye	J E
nyhani	J_h a . n i
nyhobha	J_h O . b_h a
nyoxo	J O . |\|\ O
o	O
obada	O . b_< a . d a
obhudla	O . b_h u . K\ a
obizwa	O . b_< i . z w a
obo	O . b_< O
obomvu	O . b_< O . m . v u
obu	O . b_< u
obubanda	O . b_< u . b_< a . n d a
obufikelela	O . b_< u . f i . k_> E . l E . l a
obumjongileyo	O . b_< u . m . dZ O . N g i . l E . j O
obumnyama	O . b_< u . m J a . m a
obuncinci	O . b_< u . n |\ i . n |\ i
obunomtsalane	O . b_< u . n O . m . ts_> a . l a . n E
obushushu	O . b_< u . S u . S u
obuvelileyo	O . b_< u . v E . l i . l E . j O
obuxubileyo	O . b_< u . |\|\ u . b_< i . l E . j O
obuziipesenti	O . b_< u . z i . i . p_> E . s E . n t_> i
odityanelweyo	O . d i . c_> a . n E . l w E . j O
odlala	O . K\ a . l a
ofana	O . f a . n a
ofanayo	O . f a . n a . j O
ofonyoziwe	O . f O . J O . z i . w E
ofuna	O . f u . n a
ohamba	O . h a . m b_< a
ohlakaniphileyo	O . K a . k_> a . n i . p_h i . l E . j O
ohlala	O . K a . l a
ohlaselayo	O . K a . s E . l a . j O
okanye	O . k_> a . J E
okhawulezileyo	O . k_h a . w u . l E . z i . l E . j O
okhuselayo	O . k_h u . s E . l a . j O
okhuthaza	O . k_h u . t_h a . z a
oko	O . k_> O
okokuqala	O . k_> O . k_> u . !\ a . l a
okrelekrele	O . kx_> E . l E . kx_> E . l E
oktobha	O k_> . t_> O . b_h a
oku	O . k_> u
okucangcatha	O . k_> u . |\ a . N |\g_0 a . t_h a
okufuphi	O . k_> u . f u . p_h i
okulandelayo	O . k_> u . l a . n d E . l a . j O
okulungeleyo	O . k_> u . l u . N g E . l E . j O
okumnandi	O . k_> u . m n a . n d i
okuyi	O . k_> u . j i
okuzingela	O . k_> u . z i . N g E . l a
okwakufutshane	O . k_> w a . k_> u . f u . tS_h a . n E
okwakwenzeka	O . k_> w a . k_> w E . n z E . k_> a
okwangoku	O . k_> w a . N g O . k_> u
okwenkunzi	O . k_> w E . n . k_> u . n z i
okwethutyana	O . k_> w E . t_h u . c_> a . n a
olahlekelweyo	O . l a . K E . k_> E . l w E . j O
olandelayo	O . l a . n d E . l a . j O
olo	O . l O
olu	O . l u
olubanzi	O . l u . b_< a . n z i
olubhlowu	O . l u . b_h l O . w u
olubiyileyo	O . l u . b_< i . j i . l E . j O
olubomvu	O . l u . b_< O . m . v u
olude	O . l u . d E
olugodukayo	O . l u . g O . d u . k_> a . j O
olukhawulezileyo	O . l u . k_h a . w u . l E . z i . l E . j O
olukhulu	O . l u . k_h u . l u
olulandelayo	O . l u . l a . n d E . l a . j O
oluncinci	O . l u . n |\ i . n |\ i
olungathethekiyo	O . l u . N g a . t_h E . t_h E . k_> i . j O
olungena	O . l u . N g E . n a
olungileyo	O . l u . N g i . l E . j O
olungundoqo	O . l u . N g u . n d O . !\ O
olunye	O . l u . J E
oluqhubekekayo	O . l u . !\_h u . b_< E . k_> E . k_> a . j O
olwaluphakathi	O . l w a . l u . p_h a . k_> a . t_h i
olwaziwa	O . l w a . z i . w a
omabini	O . m a . b_< i . n i
omdala	O . m d a . l a
omhlonelayo	O . m K O . n E . l a . j O
omkhulu	O . m k_h u . l u
omlambo	O . m . l a . m b_< O
omncinane	O . m . n |\ i . n a . n E
omninzi	O . m n i . n z i
omnyama	O . m J a . m a
omnye	O . m J E
omoya	O . m O . j a
omthombo	O . m t_h O . m b_< O
omtsha	O . m tS_h a
omusha	O . m u . S a
onameva	O . n a . m E . v a
oncumisayo	O . n |\ u . m i . s a . j O
onencindi	O . n E . n |\ i . n d i
onentlabathi	O . n E . n tK_> a . b_< a . t_h i
onetyhefu	O . n E . c_h E . f u
ongamandla	O . N g a . m a . n K\ a
ongaqhelekanga	O . N g a . !\_h E . l E . k_> a . N g a
ongazukuphunyelelwa	O . N g a . z u . k_> u . p_h u . J E . l E . l w a
ongcono	O . N |\g_0 O . n O
ongenalo	O . N g E . n a . l O
ongephi	O . N g E . p_h i
ongevayo	O . N g E . v a . j O
ongu	O . N g u
ongum	O . N g u . m
ongumchankcatho	O . N g u . m . |\_h a . n |\ a . t_h O
onjani	O . n dZ a . n i
onogwaja	O . n O . g w a . dZ a
onokufumana	O . n O . k_> u . f u . m a . n a
onomusa	O . n O . m u . s a
onophahla	O . n O . p_h a . K a
onqenqemeni	O . n !\ E . n !\ E . m E . n i
onzulu	O . n z u . l u
oogqirha	O . O . !\g_0 i . x a
oonobumba	O . O . n O . b_< u . m b_< a
ophangaleleyo	O . p_h a . N g a . l E . l E . j O
opheleleyo	O . p_h E . l E . l E . j O
oqingqiweyo	O . !\ i . N !\g_0 i . w E . j O
orenji	O . r E . n dZ i
osembindini	O . s E . m b_< i . n d i . n i
osenyongweni	O . s E . J O . N g w E . n i
osesibhakabhakeni	O . s E . s i . b_h a . k_> a . b_h a . k_> E . n i
oshushu	O . S u . S u
osinga	O . s i . N g a
oswelekelwe	O . s w E . l E . k_> E . l w E
othambileyo	O . t_h a . m b_< i . l E . j O
othe	O . t_h E
othile	O . t_h i . l E
otshatileyo	O . tS_h a . t_> i . l E . j O
otshekulayo	O . tS_h E . k_> u . l a . j O
otyebileyo	O . c_> E . b_< i . l E . j O
otyheli	O . c_h E . l i
ovuthuza	O . v u . t_h u . z a
ovuthuzayo	O . v u . t_h u . z a . j O
owashiyeka	O . w a . S i . j E . k_> a
owawubaleka	O . w a . w u . b_< a . l E . k_> a
owawudlula	O . w a . w u . K\ u . l a
owawulele	O . w a . w u . l E . l E
owawunqanqaza	O . w a . w u . n !\ a . n !\ a . z a
owawuphithanise	O . w a . w u . p_h i . t_h a . n i . s E
owawuvuliwe	O . w a . w u . v u . l i . w E
owayechophe	O . w a . j E . |\_h O . p_h E
owayemhle	O . w a . j E . m K E
owayemjamele	O . w a . j E . m . dZ a . m E . l E
owaziwa	O . w a . z i . w a
owenkawu	O . w E . n . k_> a . w u
owenziwa	O . w E . n z i . w a
owodwa	O . w O . d w a
owomileyo	O . w O . m i . l E . j O
owu	O . w u
oya	O . j a
oyenzileyo	O . j E . n z i . l E . j O
oyi	O . j i
oyijojileyo	O . j i . dZ O . dZ i . l E . j O
oyintandane	O . j i . n t_> a . n d a . n E
oyityileyo	O . j i . c_> i . l E . j O
oza	O . z a
oziiyadi	O . z i . i . j a . d i
ozoyifumana	O . z O . j i . f u . m a . n a
ozoyithola	O . z O . j i . t_h O . l a
paca	p_> a . |\ a
pewu	p_> E . w u
phakameni	p_h a . k_> a . m E . n i
phakathi	p_h a . k_> a . t_h i
phambi	p_h a . m b_< i
phambili	p_h a . m b_< i . l i
phandle	p_h a . n K\ E
phantse	p_h a . n ts_> E
phantsi	p_h a . n ts_> i
phaya	p_h a . j a
phayphali	p_h a . j i . p_h a . l i
phetshana	p_h E . tS_h a . n a
phezu	p_h E . z u
phezulu	p_h E . z u . l u
phi	p_h i
phindulo	p_h i . n d u . l O
phiri	p_h i . r i
phofu	p_h O . f u
phondo	p_h O . n d O
phuma	p_h u . m a
phumani	p_h u . m a . n i
phumlani	p_h u . m . l a . n i
pilloo	p_> i . l l O . O
pitoli	p_> i . t_> O . l i
piyano	p_> i . j a . n O
polokwane	p_> O . l O . k_> w a . n E
poorakha	p_> O . O . r a . k_h a
popisi	p_> O . p_> i . s i
pumla	p_> u . m . l a
qakatha	!\ a . k_> a . t_h a
qala	!\ a . l a
qaqadisa	!\ a . !\ a . d i . s a
qela	!\ E . l a
qhamani	!\_h a . m a . n i
qho	!\_h O
qhubeka	!\_h u . b_< E . k_> a
qhubekani	!\_h u . b_< E . k_> a . n i
qhuzu	!\_h u . z u
qokobhe	!\ O . k_> O . b_h E
ramatsa	r a . m a . ts_> a
ranti	r a . n t_> i
rhawutini	x a . w u . t_> i . n i
rherheba	x E . x E . b_< a
rhoqo	x O . !\ O
rhwelele	x w E . l E . l E
saba	s a . b_< a
sabaleka	s a . b_< a . l E . k_> a
sabasa	s a . b_< a . s a
sabelane	s a . b_< E . l a . n E
sabo	s a . b_< O
sachwechwa	s a . |\_h w E . |\_h w a
sagibisela	s a . g i . b_< i . s E . l a
sajoja	s a . dZ O . dZ a
sakhe	s a . k_h E
sakhile	s a . k_h i . l E
sakho	s a . k_h O
sakhulula	s a . k_h u . l u . l a
sakhwela	s a . k_h w E . l a
sakusasa	s a . k_> u . s a . s a
sakuva	s a . k_> u . v a
salibala	s a . l i . b_< a . l a
sam	s a . m
samanzi	s a . m a . n z i
samasi	s a . m a . s i
samjula	s a . m . dZ u . l a
sana	s a . n a
sancuma	s a . n |\ u . m a
sango	s a . N g O
sangokuhlwa	s a . N g O . k_> u . K w a
sanika	s a . n i . k_> a
saphuma	s a . p_h u . m a
saqalisa	s a . !\ a . l i . s a
saqubha	s a . !\ u . b_h a
sase	s a . s E
sasekwa	s a . s E . k_> w a
sasingumlilo	s a . s i . N g u . m . l i . l O
sasisenziwa	s a . s i . s E . n z i . w a
sasiye	s a . s i . j E
sasizimele	s a . s i . z i . m E . l E
sathwala	s a . t_h w a . l a
satsho	s a . tS_h O
savula	s a . v u . l a
savutha	s a . v u . t_h a
savuthulula	s a . v u . t_h u . l u . l a
saxhakamfula	s a . |\|\_h a . k_> a . m . f u . l a
saxhuma	s a . |\|\_h u . m a
saya	s a . j a
sayo	s a . j O
saza	s a . z a
se	s E
sebrakfesi	s E . b_< r a k_> . f E . s i
sedazini	s E . d a . z i . n i
seemvula	s E . E . m . v u . l a
seendaba	s E . E . n d a . b_< a
sefudi	s E . f u . d i
sehektare	s E . h E k_> . t_> a . r E
sekeyiki	s E . k_> E . j i . k_> i
sekola	s E . k_> O . l a
sele	s E . l E
selsiyasi	s E l . s i . j a . s i
sembiza	s E . m b_< i . z a
semibane	s E . m i . b_< a . n E
semililo	s E . m i . l i . l O
semimoya	s E . m i . m O . j a
senamela	s E . n a . m E . l a
sendiyozela	s E . n d i . j O . z E . l a
sendlu	s E . n K\ u
sendoda	s E . n d O . d a
senkwenkwe	s E . n . k_> w E . n . k_> w E
senqwelo	s E . n !\ w E . l O
sentsasa	s E . n ts_> a . s a
senyama	s E . J a . m a
seplastiki	s E . p_> l a . s t_> i . k_> i
septemba	s E p_> . t_> E . m b_< a
serero	s E . r E . r O
sesibini	s E . s i . b_< i . n i
sesinye	s E . s i . J E
sesiphi	s E . s i . p_h i
sesisekhaya	s E . s i . s E . k_h a . j a
sethath	s E . t_h a t_h
sethu	s E . t_h u
seva	s E . v a
sezihamba	s E . z i . h a . m b_< a
sezihlalo	s E . z i . K a . l O
sezinto	s E . z i . n t_> O
sezixeko	s E . z i . |\|\ E . k_> O
shabalala	S a . b_< a . l a . l a
shange	S a . N g E
shu	S u
shumi	S u . m i
shushu	S u . S u
sibaca	s i . b_< a . |\ a
sibalise	s i . b_< a . l i . s E
sibe	s i . b_< E
sibone	s i . b_< O . n E
sibu	s i . b_< u
sibusiso	s i . b_< u . s i . s O
side	s i . d E
sidlale	s i . K\ a . l E
sidlo	s i . K\ O
sifiso	s i . f i . s O
sifuna	s i . f u . n a
sigcwalise	s i . |\g_0 w a . l i . s E
sigquma	s i . !\g_0 u . m a
sihibandini	s i . h i . b_< a . n d i . n i
sihlangane	s i . K a . N g a . n E
sihlasele	s i . K a . s E . l E
sihlawulela	s i . K a . w u . l E . l a
sika	s i . k_> a
sikhathazeke	s i . k_h a . t_h a . z E . k_> E
sikwisihlalo	s i . k_> w i . s i . K a . l O
silale	s i . l a . l E
similo	s i . m i . l O
simxelela	s i . m . |\|\ E . l E . l a
singadibana	s i . N g a . d i . b_< a . n a
singakhuphisana	s i . N g a . k_h u . p_h i . s a . n a
singakumisa	s i . N g a . k_> u . m i . s a
singaqubhi	s i . N g a . !\ u . b_h i
singawafumana	s i . N g a . w a . f u . m a . n a
sipha	s i . p_h a
siphulaphule	s i . p_h u . l a . p_h u . l E
siqala	s i . !\ a . l a
siqaphele	s i . !\ a . p_h E . l E
siqhaqhazela	s i . !\_h a . !\_h a . z E . l a
siqwalasele	s i . !\ w a . l a . s E . l E
sisanda	s i . s a . n d a
sisekhaya	s i . s E . k_h a . j a
sisibambile	s i . s i . b_< a . m b_< i . l E
sisidlo	s i . s i . K\ O
sisigcine	s i . s i . |\g_0 i . n E
sisihlawula	s i . s i . K a . w u . l a
sisihloko	s i . s i . K O . k_> O
sisimka	s i . s i . m k_> a
sisindleka	s i . s i . n K\ E . k_> a
sisiqingatha	s i . s i . !\ i . N g a . t_h a
sisiqithi	s i . s i . !\ i . t_h i
sisitishi	s i . s i . t_> i . S i
sisityu	s i . s i . c_> u
sisiya	s i . s i . j a
sisukela	s i . s u . k_> E . l a
sithetha	s i . t_h E . t_h a
sive	s i . v E
sivule	s i . v u . l E
sixeko	s i . |\|\ E . k_> O
sixhawula	s i . |\|\_h a . w u . l a
siya	s i . j a
siyabonga	s i . j a . b_< O . N g a
siyalazi	s i . j a . l a . z i
siyanda	s i . j a . n d a
siyayibona	s i . j a . j i . b_< O . n a
siyenza	s i . j E . n z a
siyinyusela	s i . j i . J u . s E . l a
siyokulala	s i . j O . k_> u . l a . l a
siza	s i . z a
size	s i . z E
siziba	s i . z i . b_< a
sizifumene	s i . z i . f u . m E . n E
sizinxibe	s i . z i . n |\|\ i . b_< E
sizise	s i . z i . s E
sizive	s i . z i . v E
sizwe	s i . z w E
skotlani	s k_> O . tK_> a . n i
so	s O
sobabini	s O . b_< a . b_< i . n i
sobuhlanga	s O . b_< u . K a . N g a
sokubhuleka	s O . k_> u . b_h u . l E . k_> a
sokunduluka	s O . k_> u . n d u . l u . k_> a
sokuqala	s O . k_> u . !\ a . l a
sokuququzelela	s O . k_> u . !\ u . !\ u . z E . l E . l a
sokuyila	s O . k_> u . j i . l a
solwazi	s O . l w a . z i
sombutho	s O . m b_< u . t_h O
somchankcatho	s O . m . |\_h a . n |\ a . t_h O
somculo	s O . m . |\ u . l O
somdlalo	s O . m K\ a . l O
somenzi	s O . m E . n z i
somhobe	s O . m_h O . b_< E
somkhonto	s O . m k_h O . n t_> O
songeza	s O . N g E . z a
sonke	s O . n . k_> E
soqhushululu	s O . !\_h u . S u . l u . l u
soseji	s O . s E . dZ i
sosondelelwano	s O . s O . n d E . l E . l w a . n O
sotho	s O . t_h O
soweto	s O . w E . t_> O
soyisiwe	s O . j i . s i . w E
strandi	s . t_> r a . n d i
suka	s u . k_> a
suku	s u . k_> u
sukudlala	s u . k_> u . K\ a . l a
tata	t_> a . t_> a
tathu	t_> a . t_h u
tebogo	t_> E . b_< O . g O
tefo	t_> E . f O
thabazimbi	t_h a . b_< a . z i . m b_< i
thabo	t_h a . b_< O
thamsanqa	t_h a . m s a . n !\ a
thando	t_h a . n d O
thanduyise	t_h a . n d u . j i . s E
thatha	t_h a . t_h a
thathani	t_h a . t_h a . n i
thato	t_h a . t_> O
thekwini	t_h E . k_> w i . n i
themba	t_h E . m b_< a
thethani	t_h E . t_h a . n i
thina	t_h i . n a
thingi	t_h i . N g i
thoko	t_h O . k_> O
thukile	t_h u . k_> i . l E
thula	t_h u . l a
thulani	t_h u . l a . n i
thulo	t_h u . l O
tieho	t_> i . E . h O
tiisetso	t_> i . i . s E . ts_> O
titshalakazi	t_> i . tS_h a . l a . k_> a . z i
tokelo	t_> O . k_> E . l O
tokolo	t_> O . k_> O . l O
torho	t_> O . x O
tota	t_> O . t_> a
tse	ts_> E
tselane	ts_> E . l a . n E
tshepang	tS_h E . p_> a . N
tshisa	tS_h i . s a
tshwa	tS_h w a
tsiba	ts_> i . b_< a
tsibela	ts_> i . b_< E . l a
tsotsi	ts_> O . ts_> i
tu	t_> u
tumelo	t_> u . m E . l O
tyheli	c_h E . l i
tyhini	c_h i . n i
u	u
ubala	u . b_< a . l a
ubaleke	u . b_< a . l E . k_> E
ubalo	u . b_< a . l O
ubani	u . b_< a . n i
ube	u . b_< E
ubhabhe	u . b_h a . b_h E
ubhale	u . b_h a . l E
ubhengeze	u . b_h E . N g E . z E
ubhobhoyi	u . b_h O . b_h O . j i
ubhora	u . b_h O . r a
ubhudla	u . b_h u . K\ a
ubhudle	u . b_h u . K\ E
ubhuti	u . b_h u . t_> i
ubisi	u . b_< i . s i
ubize	u . b_< i . z E
ubomi	u . b_< O . m i
ubone	u . b_< O . n E
ubophelela	u . b_< O . p_h E . l E . l a
ubophelele	u . b_< O . p_h E . l E . l E
uboya	u . b_< O . j a
ubuceba	u . b_< u . |\ E . b_< a
ubuchule	u . b_< u . |\_h u . l E
ubudala	u . b_< u . d a . l a
ubugcisa	u . b_< u . |\g_0 i . s a
ubugolide	u . b_< u . g O . l i . d E
ubukhulu	u . b_< u . k_h u . l u
ubundicelile	u . b_< u . n d i . |\ E . l i . l E
ubungakanani	u . b_< u . N g a . k_> a . n a . n i
ubungqina	u . b_< u . N !\g_0 i . n a
ubushushu	u . b_< u . S u . S u
ubuso	u . b_< u . s O
ubusuku	u . b_< u . s u . k_> u
ubutywala	u . b_< u . c_> w a . l a
ubuyela	u . b_< u . j E . l a
ubuyele	u . b_< u . j E . l E
ucacise	u . |\ a . |\ i . s E
ucango	u . |\ a . N g O
ucinga	u . |\ i . N g a
ucinge	u . |\ i . N g E
ucingo	u . |\ i . N g O
ucothoza	u . |\ O . t_h O . z a
ude	u . d E
udibanisa	u . d i . b_< a . n i . s a
udini	u . d i . n i
udlale	u . K\ a . l E
udlisela	u . K\ i . s E . l a
udlula	u . K\ u . l a
udonga	u . d O . N g a
udume	u . d u . m E
udyakalashe	u . J\ a . k_> a . l a . S E
ufele	u . f E . l E
ufudo	u . f u . d O
ufudumele	u . f u . d u . m E . l E
ufumane	u . f u . m a . n E
ufuna	u . f u . n a
ugcakamele	u . |\g_0 a . k_> a . m E . l E
ugcine	u . |\g_0 i . n E
uginye	u . g i . J E
ugqatso	u . !\g_0 a . ts_> O
ugqithise	u . !\g_0 i . t_h i . s E
ugqume	u . !\g_0 u . m E
uhamba	u . h a . m b_< a
uhambo	u . h a . m b_< O
uhlale	u . K a . l E
uhlobo	u . K O . b_< O
ujikele	u . dZ i . k_> E . l E
ujingi	u . dZ i . N g i
ujingisa	u . dZ i . N g i . s a
ujonge	u . dZ O . N g E
ukhangele	u . k_h a . N g E . l E
ukhangeleka	u . k_h a . N g E . l E . k_> a
ukhenketho	u . k_h E . n . k_> E . t_h O
ukhozi	u . k_h O . z i
ukhozo	u . k_h O . z O
ukhula	u . k_h u . l a
ukhupha	u . k_h u . p_h a
ukhuphiswano	u . k_h u . p_h i . s w a . n O
ukhuseleko	u . k_h u . s E . l E . k_> O
ukhuthaza	u . k_h u . t_h a . z a
ukhwele	u . k_h w E . l E
ukodlula	u . k_> O . K\ u . l a
ukogqitha	u . k_> O . !\g_0 i . t_h a
ukrazula	u . kx_> a . z u . l a
ukrebe	u . kx_> E . b_< E
ukrobe	u . kx_> O . b_< E
uku	u . k_> u
ukuba	u . k_> u . b_< a
ukubakrelekrele	u . k_> u . b_< a . kx_> E . l E . kx_> E . l E
ukubaleka	u . k_> u . b_< a . l E . k_> a
ukubambelela	u . k_> u . b_< a . m b_< E . l E . l a
ukubila	u . k_> u . b_< i . l a
ukubona	u . k_> u . b_< O . n a
ukubonisa	u . k_> u . b_< O . n i . s a
ukubukeka	u . k_> u . b_< u . k_> E . k_> a
ukuchaphazeleka	u . k_> u . |\_h a . p_h a . z E . l E . k_> a
ukucula	u . k_> u . |\ u . l a
ukudlala	u . k_> u . K\ a . l a
ukudlisela	u . k_> u . K\ i . s E . l a
ukufa	u . k_> u . f a
ukufika	u . k_> u . f i . k_> a
ukufikelela	u . k_> u . f i . k_> E . l E . l a
ukufudumala	u . k_> u . f u . d u . m a . l a
ukufumana	u . k_> u . f u . m a . n a
ukufunda	u . k_> u . f u . n d a
ukufundela	u . k_> u . f u . n d E . l a
ukugoduka	u . k_> u . g O . d u . k_> a
ukugqabaza	u . k_> u . !\g_0 a . b_< a . z a
ukugramza	u . k_> u . G a . m z a
ukugxotha	u . k_> u . |\|\g_0 O . t_h a
ukuhamba	u . k_> u . h a . m b_< a
ukuhlangana	u . k_> u . K a . N g a . n a
ukuhleka	u . k_> u . K E . k_> a
ukuhlonela	u . k_> u . K O . n E . l a
ukujikeleza	u . k_> u . dZ i . k_> E . l E . z a
ukujonga	u . k_> u . dZ O . N g a
ukukhululeka	u . k_> u . k_h u . l u . l E . k_> a
ukukhuphisana	u . k_> u . k_h u . p_h i . s a . n a
ukukrukra	u . k_> u . kx_> u . kx_> a
ukulandela	u . k_> u . l a . n d E . l a
ukuleqa	u . k_> u . l E . !\ a
ukulibala	u . k_> u . l i . b_< a . l a
ukulikhangela	u . k_> u . l i . k_h a . N g E . l a
ukulungela	u . k_> u . l u . N g E . l a
ukumayizela	u . k_> u . m a . j i . z E . l a
ukumkani	u . k_> u . m k_> a . n i
ukumoyizela	u . k_> u . m O . j i . z E . l a
ukumshenxisa	u . k_> u . m S E . n |\|\ i . s a
ukumthukuthelela	u . k_> u . m t_h u . k_> u . t_h E . l E . l a
ukuncedisa	u . k_> u . n |\ E . d i . s a
ukunconywa	u . k_> u . n |\ O . J w a
ukunditya	u . k_> u . n d i . c_> a
ukungalingani	u . k_> u . N g a . l i . N g a . n i
ukungena	u . k_> u . N g E . n a
ukunqola	u . k_> u . n !\ O . l a
ukuphela	u . k_> u . p_h E . l a
ukuphepha	u . k_> u . p_h E . p_h a
ukuphuma	u . k_> u . p_h u . m a
ukuphumelela	u . k_> u . p_h u . m E . l E . l a
ukuqala	u . k_> u . !\ a . l a
ukuqeqesha	u . k_> u . !\ E . !\ E . S a
ukuqhayisa	u . k_> u . !\_h a . j i . s a
ukuqhubeka	u . k_> u . !\_h u . b_< E . k_> a
ukuqhubela	u . k_> u . !\_h u . b_< E . l a
ukuqhwayiza	u . k_> u . !\_h w a . j i . z a
ukuquka	u . k_> u . !\ u . k_> a
ukurhashaza	u . k_> u . x a . S a . z a
ukurhoxa	u . k_> u . x O . |\|\ a
ukusayina	u . k_> u . s a . j i . n a
ukusebenza	u . k_> u . s E . b_< E . n z a
ukusebenzisana	u . k_> u . s E . b_< E . n z i . s a . n a
ukusuka	u . k_> u . s u . k_> a
ukusukela	u . k_> u . s u . k_> E . l a
ukuthetha	u . k_> u . t_h E . t_h a
ukuthi	u . k_> u . t_h i
ukutsiba	u . k_> u . ts_> i . b_< a
ukutya	u . k_> u . c_> a
ukuvobela	u . k_> u . v O . b_< E . l a
ukuvuma	u . k_> u . v u . m a
ukuvunwa	u . k_> u . v u . n w a
ukuwela	u . k_> u . w E . l a
ukuwenza	u . k_> u . w E . n z a
ukuya	u . k_> u . j a
ukuyifakela	u . k_> u . j i . f a . k_> E . l a
ukuyigcina	u . k_> u . j i . |\g_0 i . n a
ukuyila	u . k_> u . j i . l a
ukuyithetha	u . k_> u . j i . t_h E . t_h a
ukuyixwaya	u . k_> u . j i . |\|\ w a . j a
ukuza	u . k_> u . z a
ukuze	u . k_> u . z E
ukuzigrumbela	u . k_> u . z i . G u . m b_< E . l a
ukuziphatha	u . k_> u . z i . p_h a . t_h a
ukuziqhelisa	u . k_> u . z i . !\_h E . l i . s a
ukuzithemba	u . k_> u . z i . t_h E . m b_< a
ukuzityhala	u . k_> u . z i . c_h a . l a
ukwabelana	u . k_> w a . b_< E . l a . n a
ukwazi	u . k_> w a . z i
ukwazisa	u . k_> w a . z i . s a
ukwehlisa	u . k_> w E . K i . s a
ukwenza	u . k_> w E . n z a
ulangazelelo	u . l a . N g a . z E . l E . l O
ulima	u . l i . m a
ulinqenerha	u . l i . n !\ E . n E . x a
ulumke	u . l u . m k_> E
ulungele	u . l u . N g E . l E
ulwandle	u . l w a . n K\ E
uma	u . m a
umakhulu	u . m a . k_h u . l u
umalume	u . m a . l u . m E
umama	u . m a . m a
umatrayivethi	u . m a . t_> r a . j i . v E . t_h i
umbala	u . m b_< a . l a
umbhaki	u . m . b_h a . k_> i
umbhali	u . m . b_h a . l i
umbhinqo	u . m . b_h i . n !\ O
umbhiyozo	u . m . b_h i . j O . z O
umbona	u . m b_< O . n a
umbonise	u . m b_< O . n i . s E
umboniso	u . m b_< O . n i . s O
umbutho	u . m b_< u . t_h O
umceli	u . m . |\ E . l i
umcu	u . m . |\ u
umculo	u . m . |\ u . l O
umdaka	u . m d a . k_> a
umdla	u . m K\ a
umdlali	u . m K\ a . l i
umdlalo	u . m K\ a . l O
umdwebo	u . m d w E . b_< O
umfama	u . m . f a . m a
umfanekiso	u . m . f a . n E . k_> i . s O
umfazi	u . m . f a . z i
umfo	u . m . f O
umfula	u . m . f u . l a
umgama	u . m . g a . m a
umgibe	u . m . g i . b_< E
umgqumo	u . m . !\g_0 u . m O
umhla	u . m K a
umhlaba	u . m K a . b_< a
umhlobo	u . m K O . b_< O
umjongile	u . m . dZ O . N g i . l E
umkhandi	u . m k_h a . n d i
umkhosi	u . m k_h O . s i
umkhuba	u . m k_h u . b_< a
umlambo	u . m . l a . m b_< O
umlamli	u . m . l a . m . l i
umlawuli	u . m . l a . w u . l i
umlilo	u . m . l i . l O
umlingo	u . m . l i . N g O
umlomo	u . m . l O . m O
umngxuma	u . m . N |\|\g_0 u . m a
umniniyo	u . m n i . n i . j O
umntu	u . m . n t_> u
umnumzana	u . m n u . m z a . n a
umnxeba	u . m . n |\|\ E . b_< a
umnyango	u . m J a . N g O
umona	u . m O . n a
umongo	u . m O . N g O
umoya	u . m O . j a
umoyana	u . m O . j a . n a
umphefumlo	u . m p_h E . f u . m . l O
umphelo	u . m p_h E . l O
umqeqeshi	u . m . !\ E . !\ E . S i
umqhagi	u . m . !\_h a . g i
umqhathile	u . m . !\_h a . t_h i . l E
umqhubi	u . m . !\_h u . b_< i
umqolo	u . m . !\ O . l O
umsebenzi	u . m s E . b_< E . n z i
umshumayeli	u . m S u . m a . j E . l i
umsila	u . m s i . l a
umsindo	u . m s i . n d O
umthamo	u . m t_h a . m O
umthi	u . m t_h i
umtsi	u . m . ts_> i
umuntu	u . m u . n t_> u
umvundla	u . m . v u . n K\ a
umvuzo	u . m . v u . z O
umxelela	u . m . |\|\ E . l E . l a
umxhasi	u . m . |\|\_h a . s i
umxube	u . m . |\|\ u . b_< E
umyalezo	u . m j a . l E . z O
umyeni	u . m j E . n i
umyili	u . m j i . l i
umzi	u . m z i
umzimba	u . m z i . m b_< a
umzinto	u . m z i . n t_> O
umzuzu	u . m z u . z u
unalo	u . n a . l O
unamendu	u . n a . m E . n d u
unayo	u . n a . j O
undinike	u . n d i . n i . k_> E
undize	u . n d i . z E
undlovu	u . n K\ O . v u
undwendwela	u . n d w E . n d w E . l a
uneminyaka	u . n E . m i . J a . k_> a
unentliziyo	u . n E . n tK_> i . z i . j O
unerekhodi	u . n E . r E . k_h O . d i
unexesha	u . n E . |\|\ E . S a
ungabinaxhala	u . N g a . b_< i . n a . |\|\_h a . l a
ungahoywanga	u . N g a . h O . j i . w a . N g a
ungakhathazeki	u . N g a . k_h a . t_h a . z E . k_> i
ungaluvula	u . N g a . l u . v u . l a
ungamandla	u . N g a . m a . n K\ a
unganceda	u . N g a . n |\ E . d a
ungandikhwelisa	u . N g a . n d i . k_h w E . l i . s a
ungandodlula	u . N g a . n d O . K\ u . l a
ungangena	u . N g a . N g E . n a
ungaqhwaqhwazelisi	u . N g a . !\_h w a . !\_h w a . z E . l i . s i
ungavuka	u . N g a . v u . k_> a
ungazenzakalisi	u . N g a . z E . n z a . k_> a . l i . s i
ungazihluphi	u . N g a . z i . K u . p_h i
ungenyuki	u . N g E . J u . k_> i
ungqisha	u . N !\g_0 i . S a
ungumhlobo	u . N g u . m K O . b_< O
ungumntu	u . N g u . m . n t_> u
ungxamele	u . N |\|\g_0 a . m E . l E
ungxole	u . N |\|\g_0 O . l E
unini	u . n i . n i
unjani	u . n dZ a . n i
unobubele	u . n O . b_< u . b_< E . l E
unobungangamsha	u . n O . b_< u . N g a . N g a . m S a
unogada	u . n O . g a . d a
unogwaja	u . n O . g w a . dZ a
unokrwece	u . n O . kx_> w E . |\ E
unomatse	u . n O . m a . ts_> E
unosilarha	u . n O . s i . l a . x a
unozinti	u . n O . z i . n t_> i
unozithi	u . n O . z i . t_h i
unxibe	u . n |\|\ i . b_< E
unyamezela	u . J a . m E . z E . l a
unyamezelwano	u . J a . m E . z E . l w a . n O
unyana	u . J a . n a
unyanzelekile	u . J a . n z E . l E . k_> i . l E
unyawo	u . J a . w O
upeyinte	u . p_> E . j i . n t_> E
uphakamise	u . p_h a . k_> a . m i . s E
uphawu	u . p_h a . w u
uphethwe	u . p_h E . t_h w E
uphi	u . p_h i
uphinde	u . p_h i . n d E
uphola	u . p_h O . l a
uphumelele	u . p_h u . m E . l E . l E
uqhayise	u . !\_h a . j i . s E
uqhayisele	u . !\_h a . j i . s E . l E
uqinisekile	u . !\ i . n i . s E . k_> i . l E
uqoqosho	u . !\ O . !\ O . S O
uqubhe	u . !\ u . b_h E
urhanelo	u . x a . n E . l O
urhulumente	u . x u . l u . m E . n t_> E
usafuna	u . s a . f u . n a
usalukhumbula	u . s a . l u . k_h u . m b_< u . l a
usana	u . s a . n a
usanda	u . s a . n d a
usandul'	u . s a . n d u l
usapho	u . s a . p_h O
usaqala	u . s a . !\ a . l a
usebenza	u . s E . b_< E . n z a
usebeze	u . s E . b_< E . z E
usekhona	u . s E . k_h O . n a
usenayo	u . s E . n a . j O
usenyongweni	u . s E . J O . N g w E . n i
ushiywe	u . S i . j i . w E
ushushu	u . S u . S u
usifundisa	u . s i . f u . n d i . s a
usifundise	u . s i . f u . n d i . s E
usimaqhinga	u . s i . m a . !\_h i . N g a
usindlekwa	u . s i . n K\ E . k_> w a
usinike	u . s i . n i . k_> E
usiphathele	u . s i . p_h a . t_h E . l E
usisihiba	u . s i . s i . h i . b_< a
usisiphukuphuku	u . s i . s i . p_h u . k_> u . p_h u . k_> u
usithengele	u . s i . t_h E . N g E . l E
usithumile	u . s i . t_h u . m i . l E
usiyalela	u . s i . j a . l E . l a
usizana	u . s i . z a . n a
usizi	u . s i . z i
usogqitha	u . s O . !\g_0 i . t_h a
usompempe	u . s O . m p_> E . m p_> E
usukele	u . s u . k_> E . l E
utaka	u . t_> a . k_> a
utata	u . t_> a . t_> a
uthanda	u . t_h a . n d a
uthe	u . t_h E
uthengisa	u . t_h E . N g i . s a
uthethe	u . t_h E . t_h E
uthi	u . t_h i
uthimle	u . t_h i . m . l E
uthixo	u . t_h i . |\|\ O
uthupha	u . t_h u . p_h a
utitshala	u . t_> i . tS_h a . l a
utitshalakazi	u . t_> i . tS_h a . l a . k_> a . z i
utolo	u . t_> O . l O
utshilo	u . tS_h i . l O
utshintshelwe	u . tS_h i . n tS_> E . l w E
utsho	u . tS_h O
utywala	u . c_> w a . l a
uvakalelwa	u . v a . k_> a . l E . l w a
uvaleka	u . v a . l E . k_> a
uvuka	u . v u . k_> a
uvukile	u . v u . k_> i . l E
uvule	u . v u . l E
uvuthuza	u . v u . t_h u . z a
uvuyo	u . v u . j O
uwabhale	u . w a . b_h a . l E
uwugqibile	u . w u . !\g_0 i . b_< i . l E
uxelele	u . |\|\ E . l E . l E
uxolo	u . |\|\ O . l O
uxwebhu	u . |\|\ w E . b_h u
uya	u . j a
uyadlalwa	u . j a . K\ a . l w a
uyagramza	u . j a . G a . m z a
uyahamba	u . j a . h a . m b_< a
uyakube	u . j a . k_> u . b_< E
uyakusilandela	u . j a . k_> u . s i . l a . n d E . l a
uyakuthanda	u . j a . k_> u . t_h a . n d a
uyakuze	u . j a . k_> u . z E
uyakwazi	u . j a . k_> w a . z i
uyandiqhula	u . j a . n d i . !\_h u . l a
uyaphi	u . j a . p_h i
uyasiculela	u . j a . s i . |\ u . l E . l a
uyatsha	u . j a . tS_h a
uyatsibatsiba	u . j a . ts_> i . b_< a . ts_> i . b_< a
uyavuka	u . j a . v u . k_> a
uyawazi	u . j a . w a . z i
uyawazokundixoxisa	u . j a . w a . z O . k_> u . n d i . |\|\ O . |\|\ i . s a
uyazi	u . j a . z i
uyazihlamba	u . j a . z i . K a . m b_< a
uyaziqhatha	u . j a . z i . !\_h a . t_h a
uyazithanda	u . j a . z i . t_h a . n d a
uye	u . j E
uyenza	u . j E . n z a
uyibeke	u . j i . b_< E . k_> E
uyibhaqe	u . j i . b_h a . !\ E
uyibonile	u . j i . b_< O . n i . l E
uyibonise	u . j i . b_< O . n i . s E
uyipheka	u . j i . p_h E . k_> a
uyiqhawula	u . j i . !\_h a . w u . l a
uyithwale	u . j i . t_h w a . l E
uyitsale	u . j i . ts_> a . l E
uyixwayile	u . j i . |\|\ w a . j i . l E
uyokutshintsha	u . j O . k_> u . tS_h i . n tS_> a
uza	u . z a
uzakuphela	u . z a . k_> u . p_h E . l a
uzawuva	u . z a . w u . v a
uze	u . z E
uzidla	u . z i . K\ a
uzigqibele	u . z i . !\g_0 i . b_< E . l E
uzikhumbuza	u . z i . k_h u . m b_< u . z a
uzithe	u . z i . t_h E
uzobe	u . z O . b_< E
uzodlala	u . z O . K\ a . l a
uzofunda	u . z O . f u . n d a
uzokutyiwa	u . z O . k_> u . c_> i . w a
uzole	u . z O . l E
vala	v a . l a
vilakazi	v i . l a . k_> a . z i
vimal	v i . m a l
vingci	v i . N |\g_0 i
vusi	v u . s i
waabacenga	w a . a . b_< a . |\ E . N g a
waba	w a . b_< a
wabafota	w a . b_< a . f O . t_> a
wabafumana	w a . b_< a . f u . m a . n a
wabaleka	w a . b_< a . l E . k_> a
wabalisa	w a . b_< a . l i . s a
wabambisa	w a . b_< a . m b_< i . s a
wabantwana	w a . b_< a . n t_> w a . n a
wabanye	w a . b_< a . J E
wabapeyintela	w a . b_< a . p_> E . j i . n t_> E . l a
wabathi	w a . b_< a . t_h i
wabayinxalenye	w a . b_< a . j i . n |\|\ a . l E . J E
wabe	w a . b_< E
wabeka	w a . b_< E . k_> a
wabeleka	w a . b_< E . l E . k_> a
wabemi	w a . b_< E . m i
wabetha	w a . b_< E . t_h a
wabeva	w a . b_< E . v a
wabhabha	w a . b_h a . b_h a
wabhaka	w a . b_h a . k_> a
wabhekabheka	w a . b_h E . k_> a . b_h E . k_> a
wabhekisa	w a . b_h E . k_> i . s a
wabhengeza	w a . b_h E . N g E . z a
wabhijela	w a . b_h i . dZ E . l a
wabiza	w a . b_< i . z a
wabo	w a . b_< O
wabona	w a . b_< O . n a
wabonakala	w a . b_< O . n a . k_> a . l a
wabuhlungu	w a . b_< u . K u . N g u
wabuza	w a . b_< u . z a
wacacisa	w a . |\ a . |\ i . s a
wacebisa	w a . |\ E . b_< i . s a
wacela	w a . |\ E . l a
wachankcatha	w a . |\_h a . n |\ a . t_h a
wachaza	w a . |\_h a . z a
wacinga	w a . |\ i . N g a
wacula	w a . |\ u . l a
wada	w a . d a
wade	w a . d E
wadibana	w a . d i . b_< a . n a
wadlala	w a . K\ a . l a
wadlokovisa	w a . K\ O . k_> O . v i . s a
wadlula	w a . K\ u . l a
wadlulisa	w a . K\ u . l i . s a
wadlulisela	w a . K\ u . l i . s E . l a
wafaka	w a . f a . k_> a
wafifithekisa	w a . f i . f i . t_h E . k_> i . s a
wafihla	w a . f i . K a
wafika	w a . f i . k_> a
wafikelwa	w a . f i . k_> E . l w a
wafumana	w a . f u . m a . n a
wafumanisa	w a . f u . m a . n i . s a
wafunda	w a . f u . n d a
wagqiba	w a . !\g_0 i . b_< a
wagqitywa	w a . !\g_0 i . c_> w a
wagqotsa	w a . !\g_0 O . ts_> a
waguquka	w a . g u . !\ u . k_> a
wagushugushuza	w a . g u . S u . g u . S u . z a
wahamba	w a . h a . m b_< a
wahlala	w a . K a . l a
wahlangana	w a . K a . N g a . n a
wahlangula	w a . K a . N g u . l a
wahlawulwa	w a . K a . w u . l w a
wahleka	w a . K E . k_> a
wahlunguzela	w a . K u . N g u . z E . l a
wajika	w a . dZ i . k_> a
wajinga	w a . dZ i . N g a
wajonga	w a . dZ O . N g a
waka	w a . k_> a
wakhaba	w a . k_h a . b_< a
wakhabela	w a . k_h a . b_< E . l a
wakhala	w a . k_h a . l a
wakhangela	w a . k_h a . N g E . l a
wakhe	w a . k_h E
wakho	w a . k_h O
wakhomba	w a . k_h O . m b_< a
wakhonkotha	w a . k_h O . n . k_> O . t_h a
wakhula	w a . k_h u . l a
wakhulela	w a . k_h u . l E . l a
wakhulula	w a . k_h u . l u . l a
wakhupha	w a . k_h u . p_h a
wakhuza	w a . k_h u . z a
wakhwaza	w a . k_h w a . z a
wakroba	w a . kx_> O . b_< a
wakukrobela	w a . k_> u . kx_> O . b_< E . l a
wakwazi	w a . k_> w a . z i
walibhencabhenca	w a . l i . b_h E . n |\ a . b_h E . n |\ a
walibona	w a . l i . b_< O . n a
waligrenya	w a . l i . G E . J a
walikhupha	w a . l i . k_h u . p_h a
walinda	w a . l i . n d a
walinonga	w a . l i . n O . N g a
walitsala	w a . l i . ts_> a . l a
walixhwila	w a . l i . |\|\_h w i . l a
walo	w a . l O
walowo	w a . l O . w O
walungisa	w a . l u . N g i . s a
wam	w a . m
wama	w a . m a
wamafa	w a . m a . f a
wamaqela	w a . m a . !\ E . l a
wambi	w a . m b_< i
wamema	w a . m E . m a
wamemelela	w a . m E . m E . l E . l a
wamemeza	w a . m E . m E . z a
wamhlekisa	w a . m K E . k_> i . s a
wamlandela	w a . m . l a . n d E . l a
wamncumela	w a . m . n |\ u . m E . l a
wampampatha	w a . m p_> a . m p_> a . t_h a
wamshiya	w a . m S i . j a
wamthukuthelisa	w a . m t_h u . k_> u . t_h E . l i . s a
wamwisa	w a . m w i . s a
wamxelela	w a . m . |\|\ E . l E . l a
wancama	w a . n |\ a . m a
wancancisa	w a . n |\ a . n |\ i . s a
wancuma	w a . n |\ u . m a
wandithengela	w a . n d i . t_h E . N g E . l a
wanesingqala	w a . n E . s i . N !\g_0 a . l a
wanexesha	w a . n E . |\|\ E . S a
wangari	w a . N g a . r i
wangasemva	w a . N g a . s E . m . v a
wangena	w a . N g E . n a
wangqisha	w a . N !\g_0 i . S a
wangquba	w a . N !\g_0 u . b_< a
wanika	w a . n i . k_> a
wanovuyo	w a . n O . v u . j O
wanxiba	w a . n |\|\ i . b_< a
wanyanzeleka	w a . J a . n z E . l E . k_> a
wanyuka	w a . J u . k_> a
wapapasha	w a . p_> a . p_> a . S a
wapeyinta	w a . p_> E . j i . n t_> a
waphakama	w a . p_h a . k_> a . m a
waphakamisa	w a . p_h a . k_> a . m i . s a
waphambi	w a . p_h a . m b_< i
waphaphathekisa	w a . p_h a . p_h a . t_h E . k_> i . s a
waphela	w a . p_h E . l a
waphendula	w a . p_h E . n d u . l a
waphinda	w a . p_h i . n d a
waphosa	w a . p_h O . s a
waphumela	w a . p_h u . m E . l a
waputalaza	w a . p_> u . t_> a . l a . z a
waqakatha	w a . !\ a . k_> a . t_h a
waqala	w a . !\ a . l a
waqalisa	w a . !\ a . l i . s a
waqhotsa	w a . !\_h O . ts_> a
waqhubeka	w a . !\_h u . b_< E . k_> a
waqhubela	w a . !\_h u . b_< E . l a
waqhwaba	w a . !\_h w a . b_< a
waqhwanyaqhwanyaza	w a . !\_h w a . J a . !\_h w a . J a . z a
waqwalasela	w a . !\ w a . l a . s E . l a
warhaxwa	w a . x a . |\|\ w a
warhotyoza	w a . x O . c_> O . z a
warhubuluza	w a . x u . b_< u . l u . z a
wase	w a . s E
wasekhohlo	w a . s E . k_h O . K O
wasekwa	w a . s E . k_> w a
wasela	w a . s E . l a
wasemva	w a . s E . m . v a
wasesiswini	w a . s E . s i . s w i . n i
wasichola	w a . s i . |\_h O . l a
wasixelele	w a . s i . |\|\ E . l E . l E
wasuka	w a . s u . k_> a
wathatha	w a . t_h a . t_h a
wathathelwa	w a . t_h a . t_h E . l w a
wathengela	w a . t_h E . N g E . l a
wathethelwa	w a . t_h E . t_h E . l w a
wathi	w a . t_h i
wathintela	w a . t_h i . n t_> E . l a
wathuma	w a . t_h u . m a
watsalela	w a . ts_> a . l E . l a
watshintsha	w a . tS_h i . n tS_> a
watshintshelwa	w a . tS_h i . n tS_> E . l w a
watsho	w a . tS_h O
watsibela	w a . ts_> i . b_< E . l a
watswina	w a . ts_> w i . n a
watya	w a . c_> a
watyikitya	w a . c_> i . k_> i . c_> a
wavala	w a . v a . l a
wavelelwa	w a . v E . l E . l w a
wavula	w a . v u . l a
wavuthuza	w a . v u . t_h u . z a
wawongamele	w a . w O . N g a . m E . l E
wawusekwe	w a . w u . s E . k_> w E
wawusoloko	w a . w u . s O . l O . k_> O
wawuwela	w a . w u . w E . l a
wawuzingca	w a . w u . z i . N |\g_0 a
wawuzingqengqele	w a . w u . z i . N !\g_0 E . N !\g_0 E . l E
waxelela	w a . |\|\ E . l E . l a
waxhalaba	w a . |\|\_h a . l a . b_< a
waxhentsa	w a . |\|\_h E . n ts_> a
waxolisa	w a . |\|\ O . l i . s a
waya	w a . j a
waye	w a . j E
wayebaxelela	w a . j E . b_< a . |\|\ E . l E . l a
wayebetha	w a . j E . b_< E . t_h a
wayebukele	w a . j E . b_< u . k_> E . l E
wayebuthakathaka	w a . j E . b_< u . t_h a . k_> a . t_h a . k_> a
wayedinwa	w a . j E . d i . n w a
wayedweba	w a . j E . d w E . b_< a
wayefuna	w a . j E . f u . n a
wayefunde	w a . j E . f u . n d E
wayekhathazeke	w a . j E . k_h a . t_h a . z E . k_> E
wayekhwele	w a . j E . k_h w E . l E
wayekuthanda	w a . j E . k_> u . t_h a . n d a
wayelamba	w a . j E . l a . m b_< a
wayelapho	w a . j E . l a . p_h O
wayelele	w a . j E . l E . l E
wayemgodusa	w a . j E . m . g O . d u . s a
wayemhlophe	w a . j E . m K O . p_h E
wayemshiyile	w a . j E . m S i . j i . l E
wayeneentsuku	w a . j E . n E . E . n ts_> u . k_> u
wayeneenyanga	w a . j E . n E . E . J a . N g a
wayengaba	w a . j E . N g a . b_< a
wayengakuthandi	w a . j E . N g a . k_> u . t_h a . n d i
wayengakwazi	w a . j E . N g a . k_> w a . z i
wayengekho	w a . j E . N g E . k_h O
wayengenalo	w a . j E . N g E . n a . l O
wayengenamdla	w a . j E . N g E . n a . m K\ a
wayengowokuqala	w a . j E . N g O . w O . k_> u . !\ a . l a
wayengoyena	w a . j E . N g O . j E . n a
wayengqengqa	w a . j E . N !\g_0 E . N !\g_0 a
wayenokwazi	w a . j E . n O . k_> w a . z i
wayepeyinta	w a . j E . p_> E . j i . n t_> a
wayephupha	w a . j E . p_h u . p_h a
wayeqinisekile	w a . j E . !\ i . n i . s E . k_> i . l E
wayesaxakekile	w a . j E . s a . |\|\ a . k_> E . k_> i . l E
wayesele	w a . j E . s E . l E
wayeshiye	w a . j E . S i . j E
wayesitya	w a . j E . s i . c_> a
wayethetha	w a . j E . t_h E . t_h a
wayetsiba	w a . j E . ts_> i . b_< a
wayeyimbaleki	w a . j E . j i . m b_< a . l E . k_> i
wayeyiphelisile	w a . j E . j i . p_h E . l i . s i . l E
wayezama	w a . j E . z a . m a
wayikhonkotha	w a . j i . k_h O . n . k_> O . t_h a
wayiqwangqulula	w a . j i . !\ w a . N !\g_0 u . l u . l a
wayo	w a . j O
wayokungena	w a . j O . k_> u . N g E . n a
waza	w a . z a
wazama	w a . z a . m a
waze	w a . z E
wazi	w a . z i
wazikhethela	w a . z i . k_h E . t_h E . l a
wazimela	w a . z i . m E . l a
wazinyanzela	w a . z i . J a . n z E . l a
waziphulaphula	w a . z i . p_h u . l a . p_h u . l a
waziqhoshela	w a . z i . !\_h O . S E . l a
wazithethela	w a . z i . t_h E . t_h E . l a
wazivuthulula	w a . z i . v u . t_h u . l u . l a
we	w E
wedemokhrasi	w E . d E . m O . k_h r a . s i
wedolo	w E . d O . l O
wedwa	w E . d w a
wee	w E . E
weekhilomitha	w E . E . k_h i . l O . m i . t_h a
weemoto	w E . E . m O . t_> O
weenqwelo	w E . E . n !\ w E . l O
weeorenji	w E . E . O . r E . n dZ i
wefilimu	w E . f i . l i . m u
wegolide	w E . g O . l i . d E
wehla	w E . K a
wehlabathi	w E . K a . b_< a . t_h i
wehlisa	w E . K i . s a
weleta	w E . l E . t_> a
wema	w E . m a
wemali	w E . m a . l i
wemisa	w E . m i . s a
wemka	w E . m k_> a
wena	w E . n a
wengca	w E . N |\g_0 a
wengwenya	w E . N g w E . J a
wenjabulo	w E . n dZ a . b_< u . l O
wenjenjalo	w E . n dZ E . n dZ a . l O
wenjenjeya	w E . n dZ E . n dZ E . j a
wenkawu	w E . n . k_> a . w u
wentombazana	w E . n t_> O . m b_< a . z a . n a
wenu	w E . n u
wenyama	w E . J a . m a
wenza	w E . n z a
wenze	w E . n z E
wephayphali	w E . p_h a . j i . p_h a . l i
weqela	w E . !\ E . l a
wesakhiwo	w E . s a . k_h i . w O
weshumi	w E . S u . m i
wesihloko	w E . s i . K O . k_> O
weteksi	w E . t_> E k_> . s i
wethu	w E . t_h u
wetonamente	w E . t_> O . n a . m E . n t_> E
weva	w E . v a
weza	w E . z a
weze	w E . z E
wezemfundo	w E . z E . m . f u . n d O
wezifundo	w E . z i . f u . n d O
wezihamba	w E . z i . h a . m b_< a
wezimvu	w E . z i . m . v u
wezinye	w E . z i . J E
wo	w O
wobisi	w O . b_< i . s i
wodumo	w O . d u . m O
wogwebu	w O . g w E . b_< u
woku	w O . k_> u
wokubanceda	w O . k_> u . b_< a . n |\ E . d a
wokugqibela	w O . k_> u . !\g_0 i . b_< E . l a
wokuhlanganisa	w O . k_> u . K a . N g a . n i . s a
wokukhomba	w O . k_> u . k_h O . m b_< a
wokuqala	w O . k_> u . !\ a . l a
wokusondela	w O . k_> u . s O . n d E . l a
wokuthetha	w O . k_> u . t_h E . t_h a
wokuzalwa	w O . k_> u . z a . l w a
wolutsha	w O . l u . tS_h a
womabini	w O . m a . b_< i . n i
wombindi	w O . m b_< i . n d i
womfama	w O . m . f a . m a
womhobe	w O . m_h O . b_< E
womoya	w O . m O . j a
womyezo	w O . m j E . z O
wona	w O . n a
wonke	w O . n . k_> E
wonyaka	w O . J a . k_> a
wonyulwa	w O . J u . l w a
wothuswa	w O . t_h u . s w a
woyisa	w O . j i . s a
xa	|\|\ a
xesha	|\|\ E . S a
xeshikweni	|\|\ E . S i . k_> w E . n i
xhom'i	|\|\_h O . m i
xhuma	|\|\_h u . m a
xhungu	|\|\_h u . N g u
xilongo	|\|\ i . l O . N g O
xoki	|\|\ O . k_> i
xola	|\|\ O . l a
xoxa	|\|\ O . |\|\ a
yaba	j a . b_< a
yabadlali	j a . b_< a . K\ a . l i
yabalixesha	j a . b_< a . l i . |\|\ E . S a
yabandim	j a . b_< a . n d i . m
yabangeneleli	j a . b_< a . N g E . n E . l E . l i
yabathandani	j a . b_< a . t_h a . n d a . n i
yabetha	j a . b_< E . t_h a
yabethwa	j a . b_< E . t_h w a
yabo	j a . b_< O
yabona	j a . b_< O . n a
yacinga	j a . |\ i . N g a
yade	j a . d E
yadlala	j a . K\ a . l a
yaduma	j a . d u . m a
yafaka	j a . f a . k_> a
yafumana	j a . f u . m a . n a
yagquma	j a . !\g_0 u . m a
yagqunywa	j a . !\g_0 u . J w a
yaguqa	j a . g u . !\ a
yahamba	j a . h a . m b_< a
yahlabathi	j a . K a . b_< a . t_h i
yahlulwa	j a . K u . l w a
yajika	j a . dZ i . k_> a
yajonga	j a . dZ O . N g a
yaka	j a . k_> a
yakha	j a . k_h a
yakhaba	j a . k_h a . b_< a
yakhala	j a . k_h a . l a
yakhe	j a . k_h E
yakho	j a . k_h O
yakhomba	j a . k_h O . m b_< a
yakhona	j a . k_h O . n a
yakhululwa	j a . k_h u . l u . l w a
yakugqiba	j a . k_> u . !\g_0 i . b_< a
yakwazi	j a . k_> w a . z i
yala	j a . l a
yalempatho	j a . l E . m p_> a . t_h O
yalichazela	j a . l i . |\_h a . z E . l a
yalithi	j a . l i . t_h i
yalo	j a . l O
yaloo	j a . l O . O
yam	j a . m
yama	j a . m a
yamadlelo	j a . m a . K\ E . l O
yamafu	j a . m a . f u
yamanzi	j a . m a . n z i
yamaqebengwana	j a . m a . !\ E . b_< E . N g w a . n a
yamaqela	j a . m a . !\ E . l a
yamazulu'	j a . m a . z u . l u
yambamba	j a . m b_< a . m b_< a
yamcela	j a . m . |\ E . l a
yamkrwempa	j a . m . kx_> w E . m p_> a
yamluma	j a . m . l u . m a
yamnandi	j a . m n a . n d i
yampha	j a . m p_h a
yamtsalela	j a . m . ts_> a . l E . l a
yanceda	j a . n |\ E . d a
yancuma	j a . n |\ u . m a
yanesingqala	j a . n E . s i . N !\g_0 a . l a
yangaphandle	j a . N g a . p_h a . n K\ E
yange	j a . N g E
yango	j a . N g O
yanqola	j a . n !\ O . l a
yantlitheka	j a . n tK_> i . t_h E . k_> a
yantshula	j a . n tS_> u . l a
yanxiba	j a . n |\|\ i . b_< a
yanyula	j a . J u . l a
yaphaphatheka	j a . p_h a . p_h a . t_h E . k_> a
yaphendula	j a . p_h E . n d u . l a
yaqalisa	j a . !\ a . l i . s a
yaqaqamba	j a . !\ a . !\ a . m b_< a
yaqhekeka	j a . !\_h E . k_> E . k_> a
yaqhubeka	j a . !\_h u . b_< E . k_> a
yase	j a . s E
yasekhaya	j a . s E . k_h a . j a
yasekwa	j a . s E . k_> w a
yasezantsi	j a . s E . z a . n ts_> i
yaso	j a . s O
yathatha	j a . t_h a . t_h a
yathathela	j a . t_h a . t_h E . l a
yathembisa	j a . t_h E . m b_< i . s a
yathi	j a . t_h i
yathunywa	j a . t_h u . J w a
yatsala	j a . ts_> a . l a
yatsho	j a . tS_h O
yatsibela	j a . ts_> i . b_< E . l a
yatyhala	j a . c_h a . l a
yavela	j a . v E . l a
yavula	j a . v u . l a
yavusa	j a . v u . s a
yavuthelana	j a . v u . t_h E . l a . n a
yawa	j a . w a
yawangawangisa	j a . w a . N g a . w a . N g i . s a
yawo	j a . w O
yaxhaseka	j a . |\|\_h a . s E . k_> a
yaxhuma	j a . |\|\_h u . m a
yaxhuzula	j a . |\|\_h u . z u . l a
yaxukuza	j a . |\|\ u . k_> u . z a
yaya	j a . j a
yaye	j a . j E
yayibilile	j a . j i . b_< i . l i . l E
yayibubusuku	j a . j i . b_< u . b_< u . s u . k_> u
yayigcwele	j a . j i . |\g_0 w E . l E
yayihleli	j a . j i . K E . l i
yayikhaphela	j a . j i . k_h a . p_h E . l a
yayikhupha	j a . j i . k_h u . p_h a
yayikukuba	j a . j i . k_> u . k_> u . b_< a
yayikwindawo	j a . j i . k_> w i . n d a . w O
yayikwisikhongozeli	j a . j i . k_> w i . s i . k_h O . N g O . z E . l i
yayile	j a . j i . l E
yayiluvuyo	j a . j i . l u . v u . j O
yayinentliziyo	j a . j i . n E . n tK_> i . z i . j O
yayingathandi	j a . j i . N g a . t_h a . n d i
yayingu	j a . j i . N g u
yayingubani	j a . j i . N g u . b_< a . n i
yayingumsila	j a . j i . N g u . m s i . l a
yayinxibe	j a . j i . n |\|\ i . b_< E
yayinyuka	j a . j i . J u . k_> a
yayiqukwe	j a . j i . !\ u . k_> w E
yayisetyenziselwa	j a . j i . s E . c_> E . n z i . s E . l w a
yayisihla	j a . j i . s i . K a
yayisiya	j a . j i . s i . j a
yayivaleke	j a . j i . v a . l E . k_> E
yayixhalabile	j a . j i . |\|\_h a . l a . b_< i . l E
yayiyindoda	j a . j i . j i . n d O . d a
yayiyinqanawa	j a . j i . j i . n !\ a . n a . w a
yayizakutsiba	j a . j i . z a . k_> u . ts_> i . b_< a
yayiziqokelela	j a . j i . z i . !\ O . k_> E . l E . l a
yayo	j a . j O
yayvumela	j a . j i . v u . m E . l a
yaza	j a . z a
yazama	j a . z a . m a
yaze	j a . z E
yazise	j a . z i . s E
yaziwa	j a . z i . w a
yazo	j a . z O
ye	j E
yecawa	j E . |\ a . w a
yee	j E . E
yeegusha	j E . E . g u . S a
yeepaki	j E . E . p_> a . k_> i
yegolide	j E . g O . l i . d E
yegusha	j E . g u . S a
yehla	j E . K a
yehlabathi	j E . K a . b_< a . t_h i
yeka	j E . k_> a
yekhaya	j E . k_h a . j a
yekofu	j E . k_> O . f u
yemakharoni	j E . m a . k_h a . r O . n i
yemeko	j E . m E . k_> O
yemimandla	j E . m i . m a . n K\ a
yemindlalo	j E . m i . n K\ a . l O
yeminwe	j E . m i . n w E
yeminyaka	j E . m i . J a . k_> a
yemisebenzi	j E . m i . s E . b_< E . n z i
yempahla	j E . m p_> a . K a
yena	j E . n a
yengonyama	j E . N g O . J a . m a
yenkomo	j E . n . k_> O . m O
yenkqubo	j E . n !\ u . b_< O
yenkunkuma	j E . n . k_> u . n . k_> u . m a
yentaka	j E . n t_> a . k_> a
yentloko	j E . n tK_> O . k_> O
yenu	j E . n u
yenza	j E . n z a
yenzakele	j E . n z a . k_> E . l E
yenze	j E . n z E
yenzeka	j E . n z E . k_> a
yenzeke	j E . n z E . k_> E
yesazulu	j E . s a . z u . l u
yeshedyuli	j E . S E . J\ u . l i
yeshumi	j E . S u . m i
yesibini	j E . s i . b_< i . n i
yesifo	j E . s i . f O
yesikrini	j E . s i . kx_> i . n i
yesilivera	j E . s i . l i . v E . r a
yesithathu	j E . s i . t_h a . t_h u
yesityholo	j E . s i . c_h O . l O
yesizwe	j E . s i . z w E
yesohlwayo	j E . s O . K w a . j O
yethamsanqa	j E . t_h a . m s a . n !\ a
yetshizi	j E . tS_h i . z i
yetshokholethi	j E . tS_h O . k_h O . l E . t_h i
yeva	j E . v a
yewayini	j E . w a . j i . n i
yexhegokazi	j E . |\|\_h E . g O . k_> a . z i
yeyiphi	j E . j i . p_h i
yeza	j E . z a
yezekhaya	j E . z E . k_h a . j a
yezentlalo	j E . z E . n tK_> a . l O
yezi	j E . z i
yezigulane	j E . z i . g u . l a . n E
yezingwenya	j E . z i . N g w E . J a
yezomthetho	j E . z O . m t_h E . t_h O
yezopolitiko	j E . z O . p_> O . l i . t_> i . k_> O
yezoqoqosho	j E . z O . !\ O . !\ O . S O
yhini	j i . n i
yho	j O
yi	j i
yikomiti	j i . k_> O . m i . t_> i
yilahleko	j i . l a . K E . k_> O
yimani	j i . m a . n i
yimbaleki	j i . m b_< a . l E . k_> i
yimini	j i . m i . n i
yimpendulo	j i . m p_> E . n d u . l O
yindawo	j i . n d a . w O
yindlela	j i . n K\ E . l a
yingcebiso	j i . N |\g_0 E . b_< i . s O
yingwe	j i . N g w E
yingxolokazi	j i . N |\|\g_0 O . l O . k_> a . z i
yinja	j i . n dZ a
yinkosikazi	j i . n . k_> O . s i . k_> a . z i
yinto	j i . n t_> O
yintombi	j i . n t_> O . m b_< i
yintoni	j i . n t_> O . n i
yintsini	j i . n ts_> i . n i
yinyanga	j i . J a . N g a
yipensile	j i . p_> E . n s i . l E
yipleyiti	j i . p_> l E . j i . t_> i
yityani	j i . c_> a . n i
yiya	j i . j a
yiza	j i . z a
yobisi	j O . b_< i . s i
yobuxoki	j O . b_< u . |\|\ O . k_> i
yodumo	j O . d u . m O
yohlahlo	j O . K a . K O
yokuba	j O . k_> u . b_< a
yokudlala	j O . k_> u . K\ a . l a
yokuduka	j O . k_> u . d u . k_> a
yokufikela	j O . k_> u . f i . k_> E . l a
yokufikelela	j O . k_> u . f i . k_> E . l E . l a
yokugcina	j O . k_> u . |\g_0 i . n a
yokupeyinta	j O . k_> u . p_> E . j i . n t_> a
yokuphikisana	j O . k_> u . p_h i . k_> i . s a . n a
yokuqala	j O . k_> u . !\ a . l a
yokusela	j O . k_> u . s E . l a
yokuthetha	j O . k_> u . t_h E . t_h a
yokuthimla	j O . k_> u . t_h i . m . l a
yokutsala	j O . k_> u . ts_> a . l a
yokuya	j O . k_> u . j a
yokwahlukana	j O . k_> w a . K u . k_> a . n a
yomboniso	j O . m b_< O . n i . s O
yomdyarho	j O . m . J\ a . x O
yomhlobo	j O . m K O . b_< O
yomlingo	j O . m . l i . N g O
yomnqatha	j O . m . n !\ a . t_h a
yomqala	j O . m . !\ a . l a
yomthwalo	j O . m t_h w a . l O
yona	j O . n a
yonke	j O . n . k_> E
yoo	j O . O
yophahla	j O . p_h a . K a
yophumezo	j O . p_h u . m E . z O
yosana	j O . s a . n a
yothuka	j O . t_h u . k_> a
yurophu	j u . r O . p_h u
zabe	z a . b_< E
zabo	z a . b_< O
zade	z a . d E
zadibana	z a . d i . b_< a . n a
zadlala	z a . K\ a . l a
zafika	z a . f i . k_> a
zafumana	z a . f u . m a . n a
zafuna	z a . f u . n a
zahlala	z a . K a . l a
zahleka	z a . K E . k_> a
zakhe	z a . k_h E
zakho	z a . k_h O
zakhula	z a . k_h u . l a
zalo	z a . l O
zam	z a . m
zamanzi	z a . m a . n z i
zamtsala	z a . m . ts_> a . l a
zange	z a . N g E
zantsi	z a . n ts_> i
zanwebeka	z a . n w E . b_< E . k_> a
zanyuka	z a . J u . k_> a
zaphumelelwa	z a . p_h u . m E . l E . l w a
zarhangqela	z a . x a . N !\g_0 E . l a
zase	z a . s E
zasebusika	z a . s E . b_< u . s i . k_> a
zasefama	z a . s E . f a . m a
zaselwandle	z a . s E . l w a . n K\ E
zasendle	z a . s E . n K\ E
zaso	z a . s O
zathi	z a . t_h i
zatsho	z a . tS_h O
zaveza	z a . v E . z a
zavutha	z a . v u . t_h a
zaya	z a . j a
zaye	z a . j E
zayilwa	z a . j i . l w a
zayiphosa	z a . j i . p_h O . s a
zayixhakamfula	z a . j i . |\|\_h a . k_> a . m . f u . l a
zayo	z a . j O
zazidlala	z a . z i . K\ a . l a
zazifuna	z a . z i . f u . n a
zazijinga	z a . z i . dZ i . N g a
zazimhlasela	z a . z i . m K a . s E . l a
zazinomdla	z a . z i . n O . m K\ a
zaziphi	z a . z i . p_h i
zazisele	z a . z i . s E . l E
zaziselugqatsweni	z a . z i . s E . l u . !\g_0 a . ts_> w E . n i
zazisima	z a . z i . s i . m a
zazisitya	z a . z i . s i . c_> a
zazisiye	z a . z i . s i . j E
zazolulwe	z a . z O . l u . l w E
ze	z E
zeafrika	z E . a . f r i . k_> a
zebhajethi	z E . b_h a . dZ E . t_h i
zedijithali	z E . d i . dZ i . t_h a . l i
zee	z E . E
zeendaba	z E . E . n d a . b_< a
zeengwenya	z E . E . N g w E . J a
zelizwe	z E . l i . z w E
zemifuno	z E . m i . f u . n O
zeminyaka	z E . m i . J a . k_> a
zemozulu	z E . m O . z u . l u
zendebe	z E . n d E . b_< E
zenkomo	z E . n . k_> O . m O
zeoyile	z E . O . j i . l E
zerharhathi	z E . x a . x a . t_h i
zeshedyuli	z E . S E . J\ u . l i
zeshishini	z E . S i . S i . n i
zesidanga	z E . s i . d a . N g a
zesilivere	z E . s i . l i . v E . r E
zesiseko	z E . s i . s E . k_> O
zeswekile	z E . s w E . k_> i . l E
zethu	z E . t_h u
zeva	z E . v a
zeza	z E . z a
zezemozulu	z E . z E . m O . z u . l u
zezihamba	z E . z i . h a . m b_< a
zezikhukhula	z E . z i . k_h u . k_h u . l a
zezikhululo	z E . z i . k_h u . l u . l O
zezizwe	z E . z i . z w E
zhoola	z O . O . l a
zi	z i
zibancinci	z i . b_< a . n |\ i . n |\ i
zidlala	z i . K\ a . l a
zidlale	z i . K\ a . l E
zidlalile	z i . K\ a . l i . l E
zigcadeka	z i . |\g_0 a . d E . k_> a
zigcwele	z i . |\g_0 w E . l E
zigqithile	z i . !\g_0 i . t_h i . l E
zihlatywa	z i . K a . c_> w a
zihlobo	z i . K O . b_< O
ziijalebisi	z i . i . dZ a . l E . b_< i . s i
ziingxaki	z i . i . N |\|\g_0 a . k_> i
ziingxelo	z i . i . N |\|\g_0 E . l O
ziintsholongwane	z i . i . n tS_> O . l O . N g w a . n E
ziioganikhi	z i . i . O . g a . n i . k_h i
zika	z i . k_> a
zikamama	z i . k_> a . m a . m a
zikhuphe	z i . k_h u . p_h E
zikhuseleke	z i . k_h u . s E . l E . k_> E
zikwazi	z i . k_> w a . z i
zilahlekile	z i . l a . K E . k_> i . l E
zilwanyana	z i . l w a . J a . n a
zimibala	z i . m i . b_< a . l a
zimjonge	z i . m . dZ O . N g E
zimkhitha	z i . m k_h i . t_h a
zimngqongileyo	z i . m . N !\g_0 O . N g i . l E . j O
zimnyama	z i . m J a . m a
zingabahlobo	z i . N g a . b_< a . K O . b_< O
zingakhwela	z i . N g a . k_h w E . l a
zingaphi	z i . N g a . p_h i
zingayifuni	z i . N g a . j i . f u . n i
zinto	z i . n t_> O
zintsha	z i . n tS_> a
zintsholongwane	z i . n tS_> O . l O . N g w a . n E
zintyatyambo	z i . n . c_> a . c_> a . m b_< O
zinyanga	z i . J a . N g a
ziphelile	z i . p_h E . l i . l E
zipho	z i . p_h O
ziqhulo	z i . !\_h u . l O
ziqikelela	z i . !\ i . k_> E . l E . l a
ziqikelele	z i . !\ i . k_> E . l E . l E
ziquka	z i . !\ u . k_> a
ziqulathe	z i . !\ u . l a . t_h E
zisebenza	z i . s E . b_< E . n z a
zisetyenziswa	z i . s E . c_> E . n z i . s w a
zitshintshile	z i . tS_h i . n tS_> i . l E
zitsibela	z i . ts_> i . b_< E . l a
zitye	z i . c_> E
ziwoyike	z i . w O . j i . k_> E
ziyakuthanda	z i . j a . k_> u . t_h a . n d a
ziyaphuphuma	z i . j a . p_h u . p_h u . m a
ziyokuphelisa	z i . j O . k_> u . p_h E . l i . s a
ziza	z i . z a
zizizwe	z i . z i . z w E
zoba	z O . b_< a
zobusuku	z O . b_< u . s u . k_> u
zodwa	z O . d w a
zokuhlala	z O . k_> u . K a . l a
zokuqubisana	z O . k_> u . !\ u . b_< i . s a . n a
zola	z O . l a
zombindi	z O . m b_< i . n d i
zombini	z O . m b_< i . n i
zona	z O . n a
zonke	z O . n . k_> E
zothuka	z O . t_h u . k_> a
zoyise	z O . j i . s E
zuko	z u . k_> O
zulu	z u . l u
zungu	z u . N g u
zwane	z w a . n E
zwelitsha	z w E . l i . tS_h a
